OLGA       : ALLISON    IVANA      ODELL      FERDINAND 
ROB        : HENSLEY    MEADOWS    MCCARTY   
DORIS      : DEENA      CHERRY    
WILLARD    : RASMUSSEN  FOWLER    
COLON      : ANDY       HECTOR    
MAVIS      : GERARDO   
LANDON     : VELMA      KAUFMAN   
KATHERINE  : LANGLEY    INGRID     ANTONIO   
PAGE       : CANDY     
HOOPER     : JOSH       PHELPS    
OLIVER     : ROBBY      STUART     BRIGITTE   BUCHANAN  
CASTILLO   : SYKES     
TRENTON    : MEREDITH   ROSETTA    ELIZA      CONTRERAS  NIELSEN    JOSE      
RAMSEY     : ZAMORA    
VILMA      : NAPOLEON   GOODMAN    MYERS      HARPER    
MCDONALD   : ROSE       MCFADDEN   CROSS      JUAREZ     DUKE       LINDSEY   
PEARSON    : MERCEDES   LAMBERT    COTTON     RICHARDSON
WALTON     : COPELAND   SILVA      ELIJAH     MARIANO    CHARLENE  
CARLSON    : DARRELL    FIGUEROA   ROBBINS    KELLY      WONG      
MARISOL    : ANITA      DEJESUS    WALSH      HOPKINS    CAMERON    NOEMI      LAWSON     ENID      
MARISOL    : BLAKE     
LESTER     : INES       PAMELA     ROSALIE    LANCASTER  STEWART   
MANN       : HOLT       LAWANDA   
PERRY      : MARTINEZ   JOAN       DEWITT    
KATY       : EMILY      LOTT      
MARK       : EMORY      DUKE       IRA        RODERICK  
ANTONE     : SHERMAN    ROSALES   
JOHN       : ROSETTA    JULIA      LENORA     RUSSEL    
MAXWELL    : JIMENEZ    JEREMY     MCGOWAN    OWEN      
ANNA       : BETTE      MCKENZIE   ROBLES    
LETITIA    : HAMILTON   LUCY       DUFFY     
VALERIE    : COOLEY     RICO       FLORENCE   COMPTON    FERDINAND 
MCKAY      : PRINCE     CANTRELL   GONZALO    LEBLANC    WALLS      EVAN      
PRINCE     : MCKAY      ABRAHAM    BOYD       KRYSTAL   
LUCIEN     : HATFIELD   LAUREN     GILBERT    MORENO    
CHANEY     : TYREE      EDGARDO    DANIELS    VINCENT    NEWTON     MARIANO   
GILMORE    : KNOX       CLEMENTS   ROBBIE     ELIZA      RENA      
LESLIE     : ISIAH      CURRY      VAUGHN    
MARION     : TAMMI      STEVENSON  MINNIE    
GLENN      : CARLENE    FLORES     POPE       LOTT       AISHA      WELDON    
LEE        : ADAM      
HATFIELD   : LUCIEN     WARD       CHRISTIAN  MONA      
CRYSTAL    : MERCADO    CECELIA    ADAM       NIEVES    
LUCILLE    : LEVI       OSCAR      FANNIE     HENSON     DON        STACY     
PATE       : LUPE       CARVER     CUMMINGS   TRAVIS    
MONICA     : BARTLETT   SLOAN      NANETTE    ROBIN     
LENARD     : WOODWARD   SARGENT    HOGAN     
RAMIRO     : SAM        FOSTER     BERNARDO   BETH      
PHOEBE     : MYRA       NAVARRO   
FOX        : SAM        MARIBEL    ROBBINS    JULIET     ERIK       ANDREW    
ROBERTA    : DYER       HOLT       ELVA       CORINNE    SELLERS   
BENJAMIN   : STEVENS    MONTOYA    FULLER     TANYA      KANE      
LEONOR     : KATHLEEN   ANTHONY    CALVIN     LUCY      
TILLMAN    : LILIANA    RAMOS      JIMENEZ    LOTT      
AVIS       : STOUT      LETICIA    HENRY      REILLY    
ANDERSON   : CHAVEZ     DARIN     
JENNINGS   : JESSIE     KERRI      DARRYL    
LATONYA    : ERIKA      RITA       PETERSEN  
ODESSA     : BARNES     WELCH      HILARIO    MOSLEY    
LILIANA    : TILLMAN    MCCONNELL  BERTIE     BOYER      LETICIA    JIMMIE     HOLLOWAY  
LITTLE     : THOMAS     GEORGE    
MADELINE   : MCLEOD     FRYE       MARYANNE   HENDERSON 
PERCY      : SHIRLEY    RAY       
WARD       : HATFIELD   SIMON      SHANA      SNOW       PEREZ      NORMA     
KNOX       : GILMORE    KERRY      BETHANY    ANASTASIA 
FIELDS     : DEANA      DONNA     
AMIE       : ANIBAL     TRICIA     MYERS      KENTON    
WITT       : DARCY      JOSUE      CHANCE    
CANDICE    : HUGHES     LEWIS      HICKS     
MONTGOMERY : BUCKNER    TERRY      MARCY      SANCHEZ   
JANELLE    : HOLDEN     JACLYN     BONNER     MATHIS    
HOLDEN     : JANELLE    WOLF       JAMAR      BARNETT   
DERICK     : TASHA      KIP        CHRISTIAN  SUSANNA    GONZALES  
MEREDITH   : TRENTON    WEAVER     HARMON    
WALTERS    : ANIBAL     ALVIN      BORIS      KERR       HAYDEN    
ABE        : PAMELA     ENRIQUE   
JACKIE     : TRACEY     CARISSA    ED         BUCHANAN   ODONNELL   JOHNSTON  
COPELAND   : WALTON     STEPHENS   MUNOZ     
ESTES      : TARA       ROBBINS    CHRISTIAN  FORREST    DURAN      SANCHEZ    HAWKINS   
HERRERA    : MARTINEZ   PRUITT     PUGH       JULIE     
THELMA     : ELMA       GILL       HOLDER     IRVIN      AIDA      
MILAGROS   : WILEY      DAMIAN    
ARIEL      : OSCAR      CASE       FORREST   
MERCADO    : CRYSTAL    NOLAN      HOLT       BOOTH      ADAMS      WATERS     CLINT      JOHNNIE   
MERCADO    : MCMAHON   
MCNEIL     : CARNEY     EVANGELINA CONCEPCION GUZMAN     VARGAS    
SIMON      : WARD       DEANA      ARTHUR     RODERICK  
TODD       : MILLICENT  DARRELL    BOBBIE    
MARCELINO  : TRICIA     FLOSSIE    FLORENCE   JOHNNIE    ETHEL      MERRILL   
WILCOX     : ALTON      ALVAREZ    HOLT       STEVENS    MONTOYA   
LEACH      : TABATHA    NEWMAN     HILARIO    PAULETTE   AURELIA    LORENA     SARGENT    CONSTANCE 
IRIS       : WOLF       SANDOVAL  
INES       : LESTER     BURGESS    CLARA      HAWKINS   
WEBSTER    : SUZETTE    JARROD     ROBBINS    LEONARD    BLAKE     
RAMOS      : TILLMAN    QUINCY     BRADLEY    VANCE     
BLACKWELL  : NEWTON    
ANIBAL     : AMIE       WALTERS    JANICE     SWANSON    HENRY      WONG       HILL      
DONOVAN    : RICE       JARED      HAWKINS    CROSBY     BRYAN     
LILA       : BRIAN      RICARDO   
HOBBS      : JULIA      PACHECO    DAVID      KELLER     EVANGELINE
STACIE     : ERICK      SILAS      CHANDLER   THURMAN    LAWANDA   
CHRISTI    : MARTHA     DELANEY   
LOIS       : BENITO    
JAMAAL     : WIGGINS    CORRINE    CLAUDIA    MARTIN    
BALDWIN    : WALL       FULLER     ALFRED     COFFEY     POLLARD   
MONTY      : PHILIP     DYER       ANTHONY    WHITE      KRAMER     LYNN      
HARRINGTON : NICHOLS    MICHEAL    BARBRA    
PICKETT    : ISABELLE   BOBBIE     SHEPARD    SAUNDERS   REYNOLDS  
EUGENIA    : MCKENZIE   WOLFE      SONNY      LORAINE   
SAM        : RAMIRO     FOX        GILBERT    CHAN       PRUITT     JESSE      JOSUE      ELDON     
SAM        : STACY     
OCTAVIO    : HARRELL    PHILLIPS   COOLEY     CLARK      ANNIE      GUTHRIE   
HAMILTON   : LETITIA    BRIAN      FROST      MARCI      AISHA      HELENA    
CRISTINA   : MAYS      
BRENDAN    : TREY       GLORIA     ENGLISH    KRYSTAL   
BARRY      : NICOLAS    WENDY     
WARREN     : ALTA       BURTON     FORREST   
HANNAH     : DINO       MARIA      DONALD    
ERIN       : RICHARD    JESSIE     SIMS       AUTUMN     ALBERT    
HOUSTON    : OLA        TOBY       LEONARDO   HEATH      NIEVES     WATTS     
BELL       : CALVIN     KEVIN     
SWEET      : ADAMS      BILLIE     DANA      
BARLOW     : LATISHA    WILEY     
DUNN       : BYRD       BURT       FUENTES    ALFONSO   
LANA       : DIONNE     SEBASTIAN  DWIGHT    
YANG       : OSCAR      EVANGELINA
ANDY       : COLON      ALVIN      BUCK       SHANA      COLLEEN   
HIRAM      : VONDA     
CONNIE     : WHITLEY    NIGEL      VINCENT   
BARNES     : ODESSA     DEJESUS    LEANNE     MARCI     
JEFFERSON  : BURTON     CAIN       BRADFORD   MERRILL   
PAMELA     : LESTER     ABE        ROBBIE     JULIA      SOSA      
MERCEDES   : PEARSON    DURAN      HOLLOWAY  
HORTON     : GILL       NANETTE   
HERBERT    : MCCULLOUGH PAYNE      SCOTTIE    ISABELLA  
BARRERA    : CHANG      LEANNE     ENGLAND    HILARIO    GALEN      ELVA       HUNT      
MCCONNELL  : LILIANA    CLAYTON    BRIAN      SEARS      SANDOVAL   CANTU      SCOTTIE    LANG      
ROSALIE    : LESTER     SYKES      GARNER     KENTON     HARRIET   
CHARLOTTE  : ELOISE     JOHNNIE    BARBRA    
JILL       : LANCASTER  COLLIN     MAURICE   
MAC        : HARRELL    WINFRED   
WALDO      : ELVIRA     QUINCY    
LEVI       : LUCILLE    PUGH       HELGA     
WARNER     : VONDA      ANASTASIA 
HARRELL    : OCTAVIO    MAC        HUBER      VICTOR    
GOMEZ      : RICO       HENSLEY    TONI      
SOTO       : ELOISE     TAMMIE     JACKSON   
ABRAHAM    : PRINCE     THOMPSON   EVERETT    EFREN      LON       
JIMENEZ    : MAXWELL    TILLMAN    VIRGIE    
ALLISON    : OLGA       FORBES     JARROD    
BUCKNER    : MONTGOMERY DEWAYNE    JIMMIE    
FREDERIC   : JARED      LEMUEL     KRYSTAL   
COMBS      : TARA       CARLENE    RUTLEDGE  
DODSON     : ALBA       BENNIE     CHRISTA   
REBEKAH    : FISCHER    CARR       HODGE      JOHNSON   
ROSETTA    : TRENTON    JOHN       CAITLIN    HAYS       SOLOMON    GOOD      
HARDY      : MELBA      CUMMINGS   HELGA      CASSIE    
VELASQUEZ  : ELMA       MORRIS     CRANE      PARRISH    BRYANT    
WEBER      : TABATHA    HANSON    
BAIRD      : FERN       KEITH      ESTELLA    HOLLOWAY  
ALEXANDER  : TERRI      TANNER    
BRYON      : ART        DORA       BERNADINE 
MARGARITA  : WINTERS    GONZALO    ALI       
OCONNOR    : NOLAN      EDMUND     HOMER     
ALVIN      : WALTERS    ANDY       EVANGELINA
FOREST     : WILFREDO   CROSS      CLEVELAND  DELORIS   
CHARITY    : CARMINE    VERN       VALENTINE  JACKSON    KRAMER    
COOKE      : SEARS      REUBEN     STACY     
DIONNE     : LANA       CATHERINE  NAPOLEON  
TRICIA     : AMIE       MARCELINO  NOLAN      HENDRIX    HUBBARD   
VERA       : FROST      STANTON    KANE      
NUNEZ      : TIMOTHY    HERMINIA   WILLIAMS   GAY       
ALBA       : DODSON     ODELL      WALSH      TERENCE    PETERSON  
ISSAC      : BRANDY     BURTON     GOOD       LEMUEL     MONA      
FLOSSIE    : MARCELINO  INA       
ELMA       : THELMA     VELASQUEZ  KENNEDY    NETTIE     MYRA      
BLEVINS    : GABRIELA   MITCHELL   HELGA     
BUCK       : ANDY       FRANCISCO 
NICOLE     : ALISSA     RENA      
MCMILLAN   : EVERETT    OMAR       MUNOZ     
REEVES     : BENTON     CURTIS     RUSSO      NICHOLSON 
BYRD       : DUNN       LOWE       CORRINE    FINLEY    
MOSES      : KATHARINE  HOLT      
IRWIN      : BRIGHT     TREY       CONNER     BUCKLEY   
CAITLIN    : ROSETTA    HECTOR     BUCKLEY    HOMER     
STEPHENS   : COPELAND   GARNER     MARSHALL   HOLLAND    HARPER    
SYDNEY     : DARCY      ED         STANTON    HERRING    MINNIE    
DINO       : HANNAH     SHANA      LELIA      SHIRLEY    EDWIN     
CLEMENTS   : GILMORE    BRIDGETTE  JULIET     BLAIR      HELENA     HILL      
MCCARTHY   : WHITAKER   GLADYS     PAM        THADDEUS   SALVATORE  PALMER    
OSCAR      : LUCILLE    ARIEL      YANG       RONALD     STEVEN     ETHEL     
GRIFFIN    : HULL       DUSTY      ARTHUR    
LUNA       : THOMAS     GABRIELA   COLLEEN    MELBA      DAMIAN    
MCKEE      : ROBBINS    JEAN       KRAMER     EVANGELINE
IVANA      : OLGA       PITTMAN    EARLENE    SOLOMON    TRACY     
BAKER      : ED         PUCKETT   
DEENA      : DORIS      SIMPSON    COFFEY     ALI        ANGIE      KRYSTAL   
WINTERS    : MARGARITA  FROST      WALL       GONZALES  
EMORY      : MARK       SANTIAGO   NEIL       MARCELO   
ROBBIE     : GILMORE    PAMELA     RUTLEDGE   ORR       
WEISS      : CAMERON    MARCEL    
LAUREN     : LUCIEN     HAYS       MOHAMED    JOHNSON    MAYNARD    GLOVER    
ODELL      : OLGA       ALBA       HEIDI      REGGIE     ADDIE      BETH      
KNOWLES    : WOODARD    MERCER    
ROBBY      : OLIVER     EDGARDO    CLARA      NIEVES     JULIE     
STUART     : OLIVER     CARSON     MARYANNE  
OLA        : HOUSTON    ROBINSON   FLORINE    CAROLINE  
GARTH      : MERLIN     SOSA       MARSHALL   HAWKINS    ETHEL     
BEAN       : LOURDES    WOODWARD   SUSAN      TEDDY      LAWSON     DEWITT    
ANITA      : MARISOL    MICAH     
VELMA      : LANDON     HART       ADELINE    FORREST   
KRISTIE    : BREWER     GEORGIA    MINNIE     REGINA    
ARRON      : BUDDY      BRIGITTE   HAROLD     RUSSEL     REYNOLDS   VAUGHN    
JOHANNA    : JESSE      ASHLEY     CLEMONS   
BETTE      : ANNA       SEARS      MATHIS     BRIGGS    
ROBINSON   : OLA       
TABATHA    : LEACH      WEBER      BENNIE     JERALD     RICKY     
GRIMES     : GABRIELA   BOWEN     
DARNELL    : COOLEY     SHARON     RICKY     
GILBERT    : LUCIEN     SAM        CAROLYN    SONYA     
PITTS      : DENNIS    
SANTIAGO   : EMORY      WHITAKER   FRANCIS    MAXINE     MCMAHON   
CLAYTON    : MCCONNELL  DEWAYNE    ISABELLE   OLSEN      BARR      
GARRETT    : JOYNER    
MARIA      : HANNAH     CARSON     SHANNON    CONSUELO  
FISCHER    : REBEKAH    CONRAD     LINDA      JIMMIE     MACDONALD  COTE      
CARNEY     : MCNEIL     EDGARDO    ALYSON    
DILLON     : CHRISTA    THURMAN    HOLCOMB    CALLAHAN  
CASE       : ARIEL      KEVEN      MARTHA     SHEPHERD  
PITTMAN    : IVANA      MARYANNE   AYERS      MCCARTY   
SCHNEIDER  : HORN       GRETA      BAUER     
WYATT      : LYMAN      FOREMAN    MILO       HELGA     
MCLEOD     : MADELINE   ZAMORA     KATHLEEN   DEMETRIUS 
MCLAUGHLIN : RODGERS    TREY       QUINN     
WELCH      : ODESSA     MARY       JULIA      HURLEY     VERN       GABRIELA   WOODARD    SYKES     
WELCH      : NIELSEN    TERRELL    DYLAN     
MCKENZIE   : ANNA       EUGENIA    TUCKER     GILLESPIE  LAURI     
HART       : VELMA      MARISSA    KERR      
SPENCE     : MORRIS     CAROLINE   LUISA      PATRICK   
PENNINGTON : JANINE     KRISTEN    CALVIN    
JOHNS      : BERGER     DUSTY      WHITFIELD  DECKER     DANA      
HANSON     : WEBER      FLETCHER   MARTINEZ   KARLA      BASIL     
NOLAN      : MERCADO    OCONNOR    TRICIA     ANDREA     LANE       MARA      
DEJESUS    : MARISOL    BARNES     ANGELITA  
BURT       : DUNN       ALVAREZ    AUGUSTINE  SCHWARTZ   CANDY      DELBERT   
HUNTER     : TIMMY      DIXIE      MAXINE    
MICAH      : ANITA      KATHY      CLAY       HICKS      CONCEPCION
FANNIE     : LUCILLE    BRIANA     ENGLISH   
CORY       : JOHNATHAN  BRADLY     FIGUEROA   ADDIE      CURTIS    
REYES      : CHANG      HEIDI      RODRIGUEZ  RYAN       PRISCILLA  JACKSON   
URSULA     : CECIL      LINDA     
JARVIS     : EARLENE    CASEY     
JUSTINE    : WEEKS      MARA       CALDWELL   FRANCISCO 
MARIBEL    : FOX        CLYDE      JEWELL     HENRY      ESTELLA   
RODNEY     : JACLYN     LORNA     
HEBERT     : SEARS      ROY        MARTIN     LORAINE   
SILVA      : WALTON     ODOM       PATRICK    BARTON    
JACLYN     : JANELLE    RODNEY     VERN       ALFRED    
PHILLIPS   : OCTAVIO    BILLIE    
TOBY       : HOUSTON    OWEN       BOWEN     
GONZALEZ   : POTTS      ELVIRA     DUNCAN     PARSONS   
ELLIS      : FREDDIE    DECKER     GRAHAM     ALINE     
CHARLIE    : JOY        LOURDES   
HOLMAN     : REESE      OMAR       JACOBS     HAZEL     
EDMUND     : OCONNOR    OTIS       NADINE    
FRY        : RICE       DELORIS    INGRAM    
CARSON     : STUART     MARIA      CRANE      AUBREY     ANGIE     
HUGHES     : CANDICE    BARTLETT   CARLENE    BOLTON     ELIJAH     ERICKSON  
BURGESS    : INES       SEARS      SERRANO    YVETTE    
AUSTIN     : HOLT       KEVIN     
PIERCE     : JAIME      ROXANNE    MOSLEY    
DENIS      : MORENO    
CHANG      : BARRERA    REYES      ISRAEL     JUANITA    BOWEN     
HINES      : FRYE       TARA       MILLICENT  SANTANA   
TRACEY     : JACKIE     DEANDRE    BENTLEY   
DARYL      : MIKE       LULU       HUFFMAN   
DIAZ       : ODOM       LATISHA    ERNESTINE 
CECELIA    : CRYSTAL    CLYDE     
LARSEN     : MILLER     KERI       AVERY      COFFEY     TRAVIS    
RICE       : DONOVAN    FRY        MAGGIE     ZAMORA     CORRINE   
BRIAN      : LILA       HAMILTON   MCCONNELL  NIKKI      MOHAMED    BRYANT    
JOHNATHAN  : CORY       LUCAS     
BENNIE     : DODSON     TABATHA    TABITHA   
ERICK      : STACIE     LELIA      MARVIN    
LEANNE     : BARNES     BARRERA   
KENT       : LANGLEY    PETTY      MOLINA     NORMA      STEVENSON  CAROL     
COOLEY     : VALERIE    OCTAVIO    DARNELL    CRAFT      KIP        NIKKI     
TASHA      : DERICK     STEVENS    SHARON     DURAN      FINLEY    
BERT       : GOOD       MERRITT    ALYSON     GRAHAM     RUSSEL     BRYAN      TRENT     
GUY        : ISRAEL     HENRY     
CLARK      : OCTAVIO    REGGIE     RUSSO     
TUCKER     : MCKENZIE   ENRIQUE    QUINN      GAY       
VONDA      : HIRAM      WARNER     HARVEY     PUCKETT    MOISES     ROD        COTTON     ROWE      
VONDA      : MADDEN    
FROST      : HAMILTON   VERA       WINTERS    KLINE      HULL       PAULETTE   HERRING    WELDON    
NORTON     : BARTLETT   MALDONADO 
CRAFT      : COOLEY     TAMERA     BOYD       TOMMY      DECKER     DAVENPORT 
LYDIA      : CARR       OLSEN     
FRYE       : MADELINE   HINES      ABEL       COLEMAN   
SELENA     : DONA       ROCCO      SHARRON   
BRIDGETTE  : CLEMENTS   STEELE     FRANKS     AYALA      WENDI     
WOLF       : HOLDEN     IRIS       MOLLIE     DUNLAP    
THOMAS     : LITTLE     LUNA       SARA       CONSUELO  
YOUNG      : HINTON     JANINE     HENRY      GATES      INA        RENA      
DEANDRE    : TRACEY     NGUYEN    
KIM        : BRIANA     FULTON     AVERY      BRIDGET    RACHAEL   
ENGLAND    : BARRERA    ANNIE      ANNMARIE   NOELLE    
CHELSEA    : HENSON     LOURDES    ROXANNE    SUSAN     
AGNES      : MARIE      CARMINE    FULTON     RONNY      PETERSON   JULIAN    
SILAS      : STACIE     TINA      
MAGGIE     : RICE       ELOISE     COLLIER    MARYELLEN  AYERS      CONTRERAS  GALLOWAY   TY        
HIGGINS    : GLORIA     LYNN      
TYREE      : CHANEY     RODGERS    TURNER     DANA      
ELOISE     : CHARLOTTE  SOTO       MAGGIE    
TOM        : ROSS       HERSCHEL  
MARGUERITE : LAUREL     CALDWELL   ERICKA     VEGA       MATTHEWS  
DEWAYNE    : BUCKNER    CLAYTON   
FLOYD      : BUTLER     FERNANDEZ  LATISHA    ZAMORA     BRADLEY    ERICKSON   LORAINE   
RICHARD    : ERIN       NEWMAN     FRIEDA     CONRAD     DELBERT   
EDITH      : BERTIE     CRANE      MARSH      DANA      
WHITAKER   : MCCARTHY   SANTIAGO   RICHMOND  
ANNIE      : OCTAVIO    ENGLAND    POPE       CURTIS    
FLETCHER   : HANSON    
CHRISTA    : DODSON     DILLON     HUGH       GALEN      NANETTE    JOHNSON    ESTRADA   
LEONARDO   : HOUSTON    TREVINO    CHARMAINE  HUBBARD   
LANGLEY    : KATHERINE  KENT       REFUGIO    RUSSEL    
STEFANIE   : CARLO      DONALD     MENDOZA   
STEELE     : BRIDGETTE 
BARTLETT   : MONICA     HUGHES     NORTON     HENSON     STOUT      MCCORMICK  HAZEL     
KLINE      : FROST      LORAINE   
KRISTOPHER : RUTLEDGE   STARK      WEAVER     ROBERT     JOHNNIE   
ETTA       : HALL       BURKS      WONG      
ISABELLE   : PICKETT    CLAYTON    VICTOR     MILDRED   
AMELIA     : TRAN       ESTRADA   
TARA       : ESTES      COMBS      HINES      MARGERY    ONEIL     
ALTON      : WILCOX     CHERRY     EDWIN      GATES     
BALLARD    : SANDOVAL   MATTHEWS   FREDERICK  GIBBS     
ROMERO     : CARROLL    NOEMI      KNIGHT    
RIVERA     : CARLA     
JOY        : CHARLIE    DARRELL    JOSEPH     ROSS       ERMA       RACHAEL   
ALTA       : WARREN     SANDOVAL   ROBT       CLEVELAND  ROMAN      WELDON    
MARIE      : AGNES      MARY       ROBIN      HURST      TRENT     
MCCULLOUGH : HERBERT    EDWIN      ORTIZ     
SEARS      : MCCONNELL  COOKE      BETTE      HEBERT     BURGESS    TAYLOR    
NEWMAN     : LEACH      RICHARD    GIBSON     ALYSON     GONZALES  
JODIE      : SCOTT      ALVAREZ    FLEMING    ROWE       NELDA     
JAIME      : PIERCE     KEVEN      BETH      
BROCK      : STEVEN     COLEMAN    QUINN      WELDON    
SLOAN      : MONICA     SUSAN      SALAZAR    MACIAS    
NICOLAS    : BARRY      ERICKA     MANNING   
HENSON     : LUCILLE    CHELSEA    BARTLETT   ARMSTRONG  LEVINE     LORIE      ROSARIO    WEBB      
HENSON     : HUNT      
CLAUDETTE  : GLADYS     VALENZUELA RANDALL    DEAN      
MILLICENT  : TODD       HINES      BIRD       GUZMAN    
RIOS       : MARA       SCHULTZ    BERGER     JARED      BONNER     KELLER     ALISSA    
XAVIER     : WILLIE     BLAKE      CURTIS    
CONLEY     : CLARA      DAVID      ROWE      
ROSE       : MCDONALD   WISE       JUANITA    BARBER    
MARYANNE   : MADELINE   STUART     PITTMAN    KRISTINA   BRIANA     BARNETT    ELINOR    
DAVIS      : RODRIGUEZ  HAYS       HERRING    DELBERT   
POTTS      : GONZALEZ   INGRID     BRUCE      LACY       JACOBS     ISIDRO     HEWITT    
MEDINA     : BEST      
WIGGINS    : JAMAAL     PATEL      GERARDO    TIMMY      CANDY     
BRANDY     : ISSAC      WILLIS     WILEY      RICHMOND   MAXINE     STACY     
BERTIE     : LILIANA    EDITH      SUAREZ     WATERS     MARKS      ESTELLA    VANCE     
BRIGHT     : IRWIN      BONITA     JULIO      ROSEMARY   COMPTON    WELDON    
FRANKS     : BRIDGETTE  ROBIN     
FORBES     : ALLISON    KRISTINA   GRETA      LANCASTER  JIMMIE     ASHLEE     GRAY       MATTHEWS  
FORBES     : CALVIN    
MARY       : WELCH      MARIE      CHARLENE   HUNT      
CARLENE    : GLENN      COMBS      HUGHES     ROD        ELINOR    
HARVEY     : VONDA      LINDA     
MILLER     : LARSEN     ANDREWS   
DARRELL    : CARLSON    TODD       JOY        STOUT      TINA       SUSANNA   
FEDERICO   : ARMSTRONG  INGRID     BRIDGET    RAUL      
LEWIS      : CANDICE    WALL       BAUER     
CECIL      : URSULA     ED         RICHMOND   MINNIE    
RICO       : VALERIE    GOMEZ      BENTLEY    JOHNNIE    SAVAGE    
LUCIANO    : GABRIELA   MCCRAY    
FRIEDA     : RICHARD    WOODWARD   ROBIN      WELLS      NAVARRO    MARCEL    
PETTY      : KENT       FRANKLIN  
TAYLOR     : SEARS      PAT        HARRISON   ERNA       MARVIN    
ERIKA      : LATONYA    GARRY      DEANA      HERIBERTO  JESSICA    SHANNON    CHARMAINE 
WILFREDO   : FOREST     STOUT      DANIELLE   ROCCO      CARMELO    LORI       LEANN      JAY       
WILFREDO   : SAVANNAH  
STRICKLAND : BLAIR      GALLAGHER 
CASANDRA   : BERGER     BLANCHARD  CAROLINE   FLYNN      SHERRI    
FREDDIE    : ELLIS      WILL       VASQUEZ    FERNANDEZ  REESE      TOMMY     
ISRAEL     : CHANG      GUY        LOURDES    HOGAN     
AMANDA     : FLORES     JOSEPH     ZAMORA     KRISTINE  
MOLLIE     : WOLF       SOLOMON    VAN        KERR      
GILL       : THELMA     HORTON     ENRIQUE    GRAY       BEASLEY   
BONITA     : BRIGHT     CARMINE    GLORIA     JOSUE      CHERRY     MARCIA    
GARRY      : ERIKA     
JORDAN     : MANUEL     BUDDY      GIBSON    
KATHY      : MICAH      HERIBERTO  MILDRED   
DAPHNE     : LOWE      
WALSH      : MARISOL    ALBA       TAMERA     TOWNSEND   JACKSON    FERRELL   
ANDREA     : NOLAN      CURRY      PHELPS    
TAMERA     : CRAFT      WALSH      DARCY      PRUITT    
NOE        : EARNEST    CAROL     
GIOVANNI   : ASHLEE     MCCORMICK  BERNARDO   TERRENCE  
WILL       : FREDDIE    BARBER     ALFONZO    JEWELL     LANG       STEPHENSON
JOYCE      : BURTON     LORENZO    TERENCE    FLYNN     
WHITLEY    : CONNIE     REUBEN     LOTTIE     KAUFMAN    BRADLEY   
WEEKS      : JUSTINE    LINDSAY    DUKE       MARCELO    DAVID      SAUNDERS   PASQUALE  
HILARIO    : ODESSA     LEACH      BARRERA    ALFREDA    LUCAS     
CHAN       : SAM        RONALD     MCCALL     JOHNSTON  
BEST       : MEDINA     ART        RITA       ROSEANN    MARGARITO  HAYDEN    
FLORES     : GLENN      AMANDA     VICKY      LYMAN      DONALD     IRVIN     
JOANNA     : MALDONADO  CARLO      GENARO    
DONNY      : SHIRLEY    CURRY      HAWKINS    CARLA     
BRADLY     : CORY       DALE       RODGERS    KATHLEEN   IAN       
BUTLER     : FLOYD      ROSEANN    GONZALES  
VASQUEZ    : FREDDIE    LEONARD    ENID      
NICHOLS    : HARRINGTON COOK       CUMMINGS  
KERRY      : KNOX      
BORIS      : WALTERS    CHARLENE   HEWITT    
VICKY      : FLORES     BENTON     DWIGHT    
COOK       : NICHOLS    FAULKNER   LUCY       GREENE    
ROY        : HEBERT     HENSLEY    INGRAM     DON        SCHWARTZ  
BOWERS     : WALLS      SERRANO    RENA       BAUER     
HEATH      : HOUSTON    KATHARINE  MILES      JAMAR     
STOUT      : AVIS       BARTLETT   DARRELL    WILFREDO   KIDD      
CLYDE      : MARIBEL    CECELIA    MARCUS     NOELLE    
DANIELLE   : WILFREDO   MOSS       PETERSON  
PHILIP     : MONTY      NORRIS     POOLE      BOWEN     
HANEY      : LINDA      ARTHUR     REILLY    
RUTLEDGE   : COMBS      ROBBIE     KRISTOPHER
DONA       : SELENA     ROBLES     ELISEO     LE         SAVAGE    
LOURDES    : BEAN       CHARLIE    CHELSEA    ISRAEL     BRADSHAW   LEONARD    SHARRON    EVANGELINE
MCFADDEN   : MCDONALD   SALINAS    LAURI      ALYSON    
TIMOTHY    : NUNEZ      MARSHALL   NELDA     
DIANE      : AURELIA   
NEAL       : ROBLES     MARTINEZ   FULTON     SIMS      
KATHARINE  : MOSES      HEATH      BOYD       RUSS       REFUGIO   
KRISTINA   : MARYANNE   FORBES     MABEL      LENORA     MADDEN    
BOBBIE     : TODD       PICKETT   
MANUEL     : JORDAN     NEIL       FREEMAN    ALINE     
ANNMARIE   : ENGLAND    GLADYS     ROSARIO   
SCOTT      : JODIE      REINALDO   STEVENSON 
PECK       : MALDONADO  TERRY      JOAN      
CANTRELL   : MCKAY      FOWLER     TRUDY      ROBERTSON 
JULIO      : BRIGHT     BOWMAN    
ABEL       : FRYE       MARTIN    
ROCCO      : SELENA     WILFREDO   GONZALO    ROSEANN    LORI       MERRITT   
FIGUEROA   : CARLSON    CORY       AMADO     
JULIA      : JOHN       HOBBS      PAMELA     WELCH      CAIN       CONSTANCE 
HENSLEY    : ROB        GOMEZ      ROY        RICKY     
ROXANNE    : PIERCE     CHELSEA    GRAY      
BURTON     : WARREN     JEFFERSON  ISSAC      JOYCE      WENDY      MARSH     
GLADYS     : MCCARTHY   CLAUDETTE  ANNMARIE   MCCRAY     DICK      
SIDNEY     : ELVIRA     GEORGIA   
WOODWARD   : LENARD     BEAN       FRIEDA     VEGA       ALICIA     BOWMAN    
LAMBERT    : PEARSON    DAWN       WINFRED    COLLINS   
DEANA      : FIELDS     SIMON      ERIKA      HORN      
CAROLYN    : GILBERT    MARGERY    BRENTON    NOEL      
CUNNINGHAM : SEBASTIAN  HAYS      
SARA       : THOMAS     SUZETTE    LLOYD     
KERI       : LARSEN     LEMUEL     PATSY      CURRY      TRUDY      FERDINAND  NELDA     
GONZALO    : MCKAY      MARGARITA  ROCCO      RAY        MCCARTY   
DOYLE      : BRIANA     DAREN     
ADAM       : LEE        CRYSTAL   
IGNACIO    : PAM        CATHRYN    WISE      
GREGORY    : FREDRIC    WATERS    
WOLFE      : EUGENIA   
MILES      : HEATH      EDGARDO    JACOB      GALLOWAY  
HORN       : SCHNEIDER  DEANA      EARLENE    SANFORD    CORNELIUS  GEORGIA   
MORRIS     : VELASQUEZ  SPENCE     REYNA      ANGIE     
STARK      : KRISTOPHER GOLDIE     FLYNN     
LORENZO    : JOYCE      DAMIAN     MARVIN    
KENNEDY    : ELMA       BOBBI      LANG      
ROBLES     : ANNA       DONA       NEAL       ENRIQUE   
LEBLANC    : MCKAY      MURIEL     BENTON    
REUBEN     : COOKE      WHITLEY    RYAN      
LYMAN      : WYATT      FLORES     CORNELIUS 
DALE       : BRADLY     ASHLEY     ROBERT     HOLLAND   
DARCY      : WITT       SYDNEY     TAMERA     ENRIQUE    VERN      
SERGIO     : VICKI      SELLERS   
DONNA      : FIELDS     JIMMIE     TERENCE    MARVIN    
ENRIQUE    : ABE        TUCKER     GILL       ROBLES     DARCY      GIBSON     BEASLEY   
SHERYL     : MADDEN    
MARTINEZ   : PERRY      HERRERA    HANSON     NEAL      
ART        : BRYON      BEST       ROBT       STACI      NICHOLSON 
LOTTIE     : WHITLEY    NANNIE     MAYNARD    MCGOWAN   
CHERI      : ALVAREZ    TATE       CHUCK      EVE       
COLLIER    : MAGGIE     NITA       KRAMER    
HINTON     : YOUNG      LENORE    
HUBER      : HARRELL    BOB        CASEY     
MIKE       : DARYL      CHANDLER   TRUDY     
RONALD     : OSCAR      CHAN       AYERS      GAY       
MCCALL     : CHAN       ENGLISH   
ALFREDA    : HILARIO   
KARYN      : PAM        SANDOVAL  
THOMPSON   : ABRAHAM    ED         STEPHENSON
HURLEY     : WELCH      GABRIELA   JEANNE    
HULL       : GRIFFIN    FROST      BARBER    
MARCI      : HAMILTON   BARNES     KEITH      PHILLIP    ODONNELL   REGINA    
TAMMI      : MARION     BUDDY      HERMAN     ALFRED     LON       
ELISEO     : DONA       EARLE      BIRD       DURAN     
CAMACHO    : HOLDER     FLEMING    SONNY      HODGE      AISHA     
LENORE     : HINTON     AL         WHITE      JOYNER     CROSBY    
BOYD       : PRINCE     CRAFT      KATHARINE  JOSEPH     JEANNE    
HEIDI      : ODELL      REYES      LAWANDA   
CARISSA    : JACKIE    
MALDONADO  : NORTON     JOANNA     PECK       THURMAN    ANA        JANICE     TEDDY      DARRYL    
CARMINE    : CHARITY    AGNES      BONITA     HICKS      NORA      
PAULETTE   : LEACH      FROST      PARK      
HOPKINS    : MARISOL    PRISCILLA  CORNELIUS 
MARYELLEN  : MAGGIE     CONCEPCION SCHROEDER  ODONNELL  
MOSS       : DANIELLE   HAROLD     HICKS      INGRAM    
CHANDLER   : STACIE     MIKE       MOHAMED    WATTS     
GRETA      : SCHNEIDER  FORBES     EMILE     
LORRAINE   : MCCLURE   
RASMUSSEN  : WILLARD    SHELLEY   
CROSS      : MCDONALD   FOREST     VALENZUELA ANDREW    
AYERS      : PITTMAN    MAGGIE     RONALD     LIDIA     
BEACH      : JARRED     FERRELL    KRYSTAL   
ODOM       : SILVA      DIAZ       NIGEL      FOSTER    
KENDALL    : WILEY      BERNADETTE ALYSON     SAVANNAH  
PAM        : MCCARTHY   IGNACIO    KARYN      IAN        NOEMI      FRANCISCO 
VICTORIA   : FREEMAN    FLYNN     
DENA       : LORENA     TABITHA    FRANKIE    REINALDO  
LANE       : NOLAN      RONNY      MCBRIDE   
SUAREZ     : BERTIE     TREY       DEVON     
MARA       : NOLAN      JUSTINE    RIOS       ORR        JIMMIE     ALEXANDRA  NADINE    
CLAY       : MICAH      SERRANO    BARBER    
HOLLIE     : MYERS      FLEMING    CUMMINGS  
CHAVEZ     : ANDERSON   BRADSHAW   MORROW    
LES        : MYRA       RACHAEL   
THURMAN    : STACIE     DILLON     MALDONADO  CHRISTINE  JAMAR     
HUGH       : CHRISTA    DOROTHEA   AVERY      JULIET     RICHARDSON ODONNELL   ALBERT    
SCHULTZ    : RIOS       INGRID     STEVENSON  REGINA    
SAMUEL     : BLANCHARD 
FRANCESCA  : BIRD       ARNULFO    SANFORD    BILLIE     MARVIN    
HOLCOMB    : DILLON     ZAMORA     CARR      
SHANA      : WARD       ANDY       DINO       ERMA       FREEMAN   
BUDDY      : ARRON      JORDAN     TAMMI      HECTOR     ENGLISH    HOLLOWAY  
NIGEL      : CONNIE     ODOM       PAYNE      JEAN       NAVARRO   
MILLIE     : TINA       ALYSON     ROD        CHUCK     
RICHARDS   : GARZA      PUCKETT    MCCLURE   
BERGER     : JOHNS      RIOS       CASANDRA   NITA      
BURCH      : RICHMOND   BARBER     SYBIL     
SOLIS      : WALTER     BENITO     NADINE     FUENTES    LAWANDA   
FARLEY     : DELGADO    KASEY     
DOMINGO    : LANCASTER  SHEPHERD   KEITH      SCHROEDER  GALLAGHER 
DOROTHEA   : HUGH       ELVIRA     AUBREY     SAVANNAH  
ELIZA      : TRENTON    GILMORE    COX        OLSON      HOWELL    
RODRIGUEZ  : REYES      DAVIS      RONNY     
JOSEPH     : JOY        AMANDA     BOYD       LUCAS      PEREZ      DEVON     
GALEN      : BARRERA    CHRISTA   
MOLINA     : KENT       LORI       KAUFMAN    GIBSON    
RICARDO    : LILA       SALAZAR    DONALD     VERNON     TERENCE   
CARMELO    : WILFREDO   GILLESPIE  MATTHEWS   LLOYD     
RODGERS    : MCLAUGHLIN TYREE      BRADLY    
ORR        : ROBBIE     MARA       VEGA       MUNOZ     
DAWN       : LAMBERT    KNIGHT     HARRIS     OBRIEN    
PETER      : DORA      
LULU       : DARYL      EFREN      GUZMAN     BRADFORD  
TREY       : BRENDAN    IRWIN      MCLAUGHLIN SUAREZ     FLORINE    MICHEAL    ELBERT     CHANCE    
TREY       : COTE      
HENDRIX    : TRICIA     GRAY      
SUSAN      : BEAN       CHELSEA    SLOAN      CASEY     
LUPE       : PATE       SONYA      HAROLD     HUDSON    
JONI       : ADKINS     EVAN       TERRENCE  
HERMINIA   : NUNEZ      BRIGITTE   GRACE      TAMMIE     FLYNN     
EVERETT    : ABRAHAM    MCMILLAN   MAYS       LE         TANYA     
WEAVER     : MEREDITH   KRISTOPHER NGUYEN    
NETTIE     : ELMA       ROCKY      PAYNE     
WILLIS     : BRANDY     LEANN     
VERN       : CHARITY    WELCH      JACLYN     DARCY      CALDWELL   SUSIE      EARNEST   
RITA       : LATONYA    BEST       GENEVA     COTTON     LAWSON    
EMILE      : GRETA      EARL       VALENTINE  ELLIOTT   
FERNANDEZ  : FLOYD      FREDDIE    SONYA      JEREMY     SWANSON   
ALVAREZ    : WILCOX     BURT       JODIE      CHERI      MERLE     
ED         : JACKIE     SYDNEY     BAKER      CECIL      THOMPSON   LINDSAY    CARROLL   
BOYER      : LILIANA   
FLORINE    : OLA        TREY       GABRIELA   DUKE       RICKY      AYALA      HOFFMAN   
FOWLER     : WILLARD    CANTRELL   CONNER     DANIEL     RENA       HAYDEN    
LATISHA    : BARLOW     DIAZ       FLOYD      AUBREY     GRACIELA   DANIAL    
LETICIA    : AVIS       LILIANA    CONTRERAS  HEWITT    
CARLO      : STEFANIE   JOANNA     MAE        EDGARDO    PORTER     LAWSON    
CONRAD     : FISCHER    RICHARD    ROJAS      TERENCE    MICHAEL   
ELVIRA     : WALDO      GONZALEZ   SIDNEY     DOROTHEA   PATSY     
MERLIN     : GARTH      BENTON     DAMIAN    
KOCH       : NANNIE     COTE       GEORGIA   
PARK       : PAULETTE   ROSEMARY   LAURI      GIBBS      DANA      
KEVEN      : CASE       JAIME      NANETTE    PRUITT     BILLIE    
ARMSTRONG  : HENSON     FEDERICO   INGRID     DYER       LLOYD     
KURT       : CORTEZ     ELINOR    
ZAMORA     : RAMSEY     MCLEOD     RICE       FLOYD      AMANDA     HOLCOMB    BUCHANAN  
SEBASTIAN  : LANA       CUNNINGHAM FRANKIE   
AL         : LENORE     MUELLER    MOISES    
MARCUS     : CLYDE      GALLOWAY  
MICHEAL    : HARRINGTON TREY       ROD        SALVATORE 
BLANCHARD  : CASANDRA   SAMUEL     PUCKETT    SALVATORE 
TREVINO    : LEONARDO   NANNIE     DELGADO    GATES     
DUSTY      : GRIFFIN    JOHNS      WISE       JARRED     REILLY    
BRIGITTE   : OLIVER     ARRON      HERMINIA   GRAHAM    
ROSS       : TOM        JOY        NIKKI     
SONYA      : GILBERT    LUPE       FERNANDEZ  GERARDO   
LELIA      : DINO       ERICK      JAYNE      KARLA     
ROSEANN    : BEST       BUTLER     ROCCO      ROOSEVELT  CAIN       ROBERT     DARRYL    
OTIS       : EDMUND     AURELIA    GRAHAM    
NORRIS     : PHILIP     ISABELLA   MARKS      NORMA      ELLIOTT    JACKSON    FINLEY    
SALAZAR    : SLOAN      RICARDO    RICHARDSON
MAE        : CARLO      GARZA      OLSEN      MADDEN    
WILEY      : MILAGROS   BARLOW     BRANDY     KENDALL    OWEN      
LEVINE     : HENSON     JEREMY     BEASLEY   
NITA       : COLLIER    BERGER     YVETTE     SANCHEZ   
CATHERINE  : DIONNE     JANETTE    JULIET     JILLIAN   
BARKER     : TATE       MAYER     
JESSIE     : JENNINGS   ERIN       JACKSON    KRAMER    
PATEL      : WIGGINS    DARIN      LE        
LORI       : WILFREDO   ROCCO      MOLINA     MAYS       CHARLENE  
TERRI      : ALEXANDER  GOLDIE     SHEPHERD   HERMAN    
MAYS       : CRISTINA   EVERETT    LORI       ANTONIO    SAVAGE    
FOREMAN    : WYATT     
ROCKY      : NETTIE     MASSEY     MACIAS    
GERARDO    : MAVIS      WIGGINS    SONYA      NIELSEN    TORRES    
FRANCES    : GLASS      SERRANO    CONCEPCION ANGELITA  
EDGARDO    : CHANEY     ROBBY      CARNEY     MILES      CARLO     
PORTER     : CARLO      LEROY      KEVIN     
NANETTE    : MONICA     HORTON     CHRISTA    KEVEN      WHITE     
PACHECO    : HOBBS      ANTHONY    SELLERS   
KATHLEEN   : LEONOR     MCLEOD     BRADLY     GOLDIE     WELDON    
SHIRLEY    : PERCY      DINO       DONNY      WHITFIELD  SERRANO    WELLS      BENTON     BURKS     
AURELIA    : LEACH      DIANE      OTIS      
POPE       : GLENN      ANNIE     
VICTOR     : HARRELL    ISABELLE   LUCY      
DANIELS    : CHANEY     WILFORD   
MARTHA     : CHRISTI    CASE       BOB        MYERS     
BRIANA     : FANNIE     KIM        MARYANNE   DOYLE      ALFONZO    SIMONE    
REYNA      : MORRIS     MABEL      PRESTON    DUNCAN     HOOD      
QUINCY     : RAMOS      WALDO      MORENO     DANA      
HOLDER     : THELMA     CAMACHO   
NAPOLEON   : VILMA      DIONNE    
GABRIELA   : BLEVINS    LUNA       GRIMES     WELCH      LUCIANO    HURLEY     FLORINE    TATE      
GABRIELA   : CHERRY    
BETHANY    : KNOX       EARL       MAYER      KRISTINE  
SHEPARD    : PICKETT    JOSEPHINE  LOGAN     
LAUREL     : MARGUERITE NORA       SYKES      ANNABELLE 
FLORENCE   : VALERIE    MARCELINO  CALDWELL   JACOB     
ROSA       : JAMAR      NATASHA   
HAROLD     : ARRON      MOSS       LUPE       MARISSA   
SANDOVAL   : IRIS       MCCONNELL  BALLARD    ALTA       KARYN      JULIET    
HENRIETTA  : ADKINS     SCHWARTZ   JOHNSON   
WHITFIELD  : JOHNS      SHIRLEY    EVANGELINA JEAN      
CLARA      : INES       ROBBY      CONLEY     ERICKSON   LANG      
FULTON     : KIM        AGNES      NEAL       BRAY       ANGIE     
ROBIN      : MONICA     MARIE      FRANKS     FRIEDA     BERNARDO  
WALTER     : SOLIS     
JANINE     : PENNINGTON YOUNG      BOWEN     
BENTLEY    : TRACEY     RICO       RICK       PARSONS   
JASPER     : LINDSAY    ROBBINS    FAULKNER   REGINA    
ERNESTINE  : DIAZ       LEONEL     SHARON     DUNCAN    
GARZA      : RICHARDS   MAE        HUFFMAN    AMADO      DAMON     
EVANGELINA : MCNEIL     YANG       ALVIN      WHITFIELD  VEGA       CINDY     
SHAWN      : WALL       WALLER     MCCLURE   
INGRID     : KATHERINE  POTTS      FEDERICO   SCHULTZ    ARMSTRONG  RUSSO     
LINDA      : FISCHER    URSULA     HARVEY     HANEY     
SIMS       : ERIN       NEAL       SAMPSON    WILLIE     SCHROEDER  BARTON    
MURIEL     : LEBLANC    DELORIS   
ANNETTE    : JIMMIE     KRISTINE   RACHAEL   
LORIE      : HENSON    
MYRA       : PHOEBE     ELMA       LES        WILLIE    
GLASS      : FRANCES   
LINDSAY    : WEEKS      ED         JASPER     BRADSHAW   CONSTANCE 
ROBT       : ALTA       ART        IRA        JOHNNIE   
PRUITT     : HERRERA    SAM        TAMERA     KEVEN      GALLOWAY  
FOSTER     : RAMIRO     ODOM       SANFORD    PARSONS   
VINCENT    : CHANEY     CONNIE     BRENTON    PATRICK   
NOELLE     : ENGLAND    CLYDE      PRESTON   
GOODMAN    : VILMA      ISABELLA   BARTON    
RYAN       : REYES      REUBEN     JOSE       ANNABELLE 
RICHMOND   : WHITAKER   BRANDY     CECIL      BURCH      JARED      ALINE     
LUCAS      : JOHNATHAN  HILARIO    JOSEPH     JERALD     ANASTASIA 
DYER       : ROBERTA    MONTY      ARMSTRONG  NOEMI      LYNN       POLLARD   
RUSSELL    : ASHLEY     ANDREWS    VERNON     BEASLEY   
BOB        : HUBER      MARTHA     MILO      
MARIANA    : AVA        LARSON    
CRANE      : VELASQUEZ  CARSON     EDITH      DANIAL    
ADELINE    : VELMA      JARROD    
GINGER     : SETH       MATHIS    
NANNIE     : LOTTIE     KOCH       TREVINO    JOAN      
MALLORY    : HARRISON   DANIAL     LAWANDA   
REESE      : HOLMAN     FREDDIE    KEITH     
WILBUR     : ISIDRO    
CLEVELAND  : FOREST     ALTA       MARIANO    MILO       BRIDGET   
HOLT       : MANN       ROBERTA    MERCADO    WILCOX     MOSES      AUSTIN     MONA      
LEONEL     : ERNESTINE  DECKER    
BOOTH      : MERCADO    MENDOZA   
FERN       : BAIRD      GIBBS      REGINA    
CALDWELL   : JUSTINE    MARGUERITE VERN       FLORENCE   SETH      
WILFORD    : DANIELS    HUBBARD    STEVENSON  KANE      
HENDERSON  : MADELINE   AHMED     
LANCASTER  : LESTER     JILL       FORBES     DOMINGO    WISE       KYLE       SHERMAN   
MARGARITO  : BEST       FLYNN     
BOLTON     : HUGHES     ASHLEY     JOSH      
BRUCE      : POTTS     
DENNIS     : PITTS      HAYS      
HAYS       : ROSETTA    LAUREN     DAVIS      CUNNINGHAM DENNIS     JANICE     ELBERT    
SUZETTE    : WEBSTER    SARA       BRENTON   
BROWN      : BATTLE     CASSIE    
KELLEY     : ELIJAH    
RODRIQUEZ  : DAREN      ADDIE     
JERALD     : TABATHA    LUCAS      DAVENPORT  RODERICK  
DELACRUZ   : NORA       REGGIE    
FREDRIC    : GREGORY    OMAR       VICKI      TRUDY      JULIAN    
ANA        : MALDONADO 
JIMMIE     : LILIANA    BUCKNER    FISCHER    FORBES     DONNA      MARA       ANNETTE    CARROLL   
JIMMIE     : GRAHAM    
MYERS      : VILMA      AMIE       HOLLIE     MARTHA     DEANNE     CHANCE    
EARL       : EMILE      BETHANY    SWANSON    SOLOMON    DUNLAP    
VIRGIE     : JIMENEZ    JANETTE    ALICIA     GIBSON     ERIK      
STEVEN     : OSCAR      BROCK      CASSIE    
ANTONIA    : BERNADETTE
LIZZIE     : CARR      
CATHRYN    : IGNACIO   
MARGERY    : TARA       CAROLYN    MITCHELL  
SNOW       : WARD       ENID       DEAN      
WISE       : ROSE       IGNACIO    DUSTY      LANCASTER  WASHINGTON
AUGUSTINE  : BURT       STANTON    SUSANNA   
GLORIA     : BRENDAN    HIGGINS    BONITA     GOODWIN    BILLIE    
CONTRERAS  : TRENTON    MAGGIE     LETICIA    HUDSON    
FLEMING    : JODIE      CAMACHO    HOLLIE     TOMMY      MARSH     
CAMERON    : MARISOL    WEISS      LORENA    
ESMERALDA  : BREWER     INGRAM     ISIDRO    
HICKS      : CANDICE    MICAH      CARMINE    MOSS       BRADLEY    MOODY      WALL       BERNARDO  
HICKS      : GLOVER    
OMAR       : MCMILLAN   HOLMAN     FREDRIC    MERCER     NAVARRO    MCBRIDE   
GEORGE     : LITTLE     JESSICA    SHELLEY    NGUYEN    
AURORA     : DELMAR     MOODY     
PRISCILLA  : REYES      HOPKINS    GATES      MARSHALL   LEON      
CALLAHAN   : DILLON     JANICE     DAMIAN    
ROSEMARY   : BRIGHT     PARK       JARED     
FRANCIS    : SANTIAGO   ARNULFO    PETERSEN  
TAMMY      : PARRISH    RICKY      FUENTES   
LEANN      : WILFREDO   WILLIS    
ERICKA     : MARGUERITE NICOLAS    BENTON    
JANETTE    : CATHERINE  VIRGIE     CLARENCE   OWEN      
EARLENE    : IVANA      JARVIS     HORN       HUDSON     MCBRIDE   
JACOB      : MILES      FLORENCE   NANCY     
CONNER     : IRWIN      FOWLER     MINNIE     JOHNSTON   ETHEL     
DELMAR     : AURORA     TRAN       MCLEAN     HEWITT     LINDSEY   
TATE       : CHERI      BARKER     GABRIELA   TANIA      BRYAN      VAUGHN    
KIP        : DERICK     COOLEY    
WALLS      : MCKAY      BOWERS    
NIKKI      : BRIAN      COOLEY     ROSS       JOHNSTON   GLOVER    
GUTHRIE    : OCTAVIO    RUSS       MARTIN    
ASHLEE     : FORBES     GIOVANNI   KELLER     LACEY      EVANGELINE TRACY     
MASSEY     : ROCKY      MILDRED    GALLOWAY   RUSSO     
TOMMY      : CRAFT      FREDDIE    FLEMING    COLLIN    
STEVENS    : BENJAMIN   WILCOX     TASHA      GENARO    
COLLEEN    : ANDY       LUNA       WILKINSON 
VEGA       : MARGUERITE WOODWARD   ORR        EVANGELINA ROWE       DEAN      
TERRY      : MONTGOMERY PECK       WATTS     
NORA       : CARMINE    LAUREL     DELACRUZ   ELBERT    
JESSE      : SAM        JOHANNA    MARCY      IRA        SANCHEZ   
ASHLEY     : JOHANNA    DALE       RUSSELL    BOLTON    
BERNADETTE : KENDALL    ANTONIA    WILKERSON  TRUDY      BRYAN     
TIMMY      : HUNTER     WIGGINS    ERMA       MILDRED   
JANICE     : ANIBAL     MALDONADO  HAYS       CALLAHAN   BRUNO      DAMON     
MONTOYA    : BENJAMIN   WILCOX     MERRITT   
EFREN      : ABRAHAM    LULU       EDWIN     
HERIBERTO  : ERIKA      KATHY      JAY        DANIEL     GAY       
SHARON     : DARNELL    TASHA      ERNESTINE  JACKSON    GREENE    
JUANITA    : CHANG      ROSE       SCOTTIE    BERNARDO  
AHMED      : HENDERSON  VICKI      CASSIE    
CARR       : REBEKAH    LYDIA      HOLCOMB    LIZZIE     COLLIN     BRADFORD  
JARROD     : WEBSTER    ALLISON    ADELINE   
STEWART    : LESTER     SHEPHERD   TINA       BLAKE     
RAY        : PERCY      GONZALO    MCCRAY     RUSSO      LOGAN     
TRAN       : AMELIA     DELMAR     HUMBERTO  
MCCORMICK  : BARTLETT   GIOVANNI   ROD        HARRIS     PARSONS   
JUAREZ     : MCDONALD   MCCRAY     ELBERT     MCCARTY   
VALENTINE  : CHARITY    EMILE      BULLOCK    ADDIE      LOGAN     
SERRANO    : BURGESS    BOWERS     CLAY       FRANCES    SHIRLEY    MANNING   
DUKE       : MCDONALD   MARK       WEEKS      FLORINE    JOSH       WONG      
HECTOR     : COLON      CAITLIN    BUDDY      SONNY      LAWANDA    KERR      
LACY       : POTTS      CHARMAINE 
AVERY      : LARSEN     KIM        HUGH       IRA       
MELBA      : HARDY      LUNA       RUSS      
GOLDIE     : STARK      TERRI      KATHLEEN   BRAY       REYNOLDS  
ISIAH      : LESLIE     HUMBERTO  
JEREMY     : MAXWELL    FERNANDEZ  LEVINE     KIDD       BURRIS     COMPTON   
BARBER     : ROSE       WILL       HULL       CLAY       BURCH     
LOWE       : BYRD       DAPHNE     FAULKNER   CAIN       ARTHUR     HOGAN     
ALFONZO    : WILL       BRIANA     CINDY     
BUCKLEY    : IRWIN      CAITLIN    DAREN      CONSTANCE 
CRAIG      : GONZALES  
ROBBINS    : CARLSON    FOX        ESTES      WEBSTER    MCKEE      JASPER    
MABEL      : KRISTINA   REYNA      VERNON    
RUSS       : KATHARINE  GUTHRIE    MELBA      ADAMS      LESSIE    
KIDD       : STOUT      JEREMY     COLLIN     CEDRIC     HUNT      
FAULKNER   : COOK       JASPER     LOWE      
SAMPSON    : SIMS       WENDY      NADINE     BURKS      ENID      
ANDREWS    : MILLER     RUSSELL    SOFIA      LIDIA     
SALINAS    : MCFADDEN   GRACIELA  
DELANEY    : CHRISTI    MERRILL   
AVA        : MARIANA    FRANCISCO  REILLY    
NEIL       : EMORY      MANUEL     KRISTINE  
RAYMOND    : PUCKETT    ROYCE     
BUCHANAN   : OLIVER     JACKIE     ZAMORA     BRADLEY    GENEVA    
EMILY      : KATY       ROD       
CONCEPCION : MCNEIL     MICAH      MARYELLEN  FRANCES    DAREN      RAPHAEL    ROMAN     
KAUFMAN    : LANDON     WHITLEY    MOLINA     MERRITT    FINLEY    
BRADLEY    : RAMOS      FLOYD      WHITLEY    HICKS      BUCHANAN  
JAYNE      : LELIA      ROMAN      KERR      
SIMONE     : BRIANA     RORY      
SHEPHERD   : CASE       DOMINGO    TERRI      STEWART    DEVON     
WILLIAMS   : NUNEZ      COX        REFUGIO   
MCINTYRE   : MUELLER    ANASTASIA 
WILKINSON  : COLLEEN    JARRED     WINFRED    MCGOWAN    FINLEY     HAYDEN    
CAROLINE   : OLA        SPENCE     CASANDRA   DAMIAN     MACDONALD 
HOMER      : OCONNOR    CAITLIN    DELGADO    CARVER     WINFRED   
PARRISH    : VELASQUEZ  TAMMY      JOSUE      AISHA      POOLE      JULIAN    
COX        : ELIZA      WILLIAMS  
STACI      : ART        MEADOWS    GILES      JACKSON   
JACOBS     : HOLMAN     POTTS      WOODARD    OWEN      
ROSARIO    : HENSON     ANNMARIE  
MEADOWS    : ROB        STACI      ROJAS      KRISTINE   HOWARD     ANGIE      CHARLES   
BRADSHAW   : LOURDES    CHAVEZ     LINDSAY   
MUELLER    : AL         MCINTYRE   GOOD      
HAZEL      : HOLMAN     BARTLETT   LESSIE    
JARRED     : BEACH      DUSTY      WILKINSON  DELORIS   
BRUNO      : JANICE    
SWANSON    : ANIBAL     FERNANDEZ  EARL       PEREZ      PAT       
CARROLL    : ROMERO     ED         JIMMIE     MARTIN    
VALENCIA   : HERSCHEL   KASEY     
PRESTON    : REYNA      NOELLE     ROYCE      LORAINE   
PEREZ      : WARD       JOSEPH     SWANSON    DECKER    
MARCELO    : EMORY      WEEKS     
MILLS      : CAIN      
GENEVA     : RITA       BUCHANAN   TOWNSEND   PETERSON  
ERMA       : JOY        SHANA      TIMMY      PUCKETT    LEMUEL     LORAINE   
TINA       : SILAS      DARRELL    MILLIE     STEWART   
TOWNSEND   : WALSH      GENEVA     AUBREY    
BRENTON    : CAROLYN    VINCENT    SUZETTE   
DELORIS    : FOREST     FRY        MURIEL     JARRED     SYBIL      ISIDRO     BAUER     
CANTU      : MCCONNELL  PUCKETT   
PAYNE      : HERBERT    NIGEL      NETTIE    
ANTHONY    : LEONOR     MONTY      PACHECO    JEAN       SAUNDERS  
DELGADO    : FARLEY     TREVINO    HOMER      RANDOLPH   DUFFY     
MCCRAY     : LUCIANO    GLADYS     RAY        JUAREZ     LUISA      MATHIS     ALBERTO   
FREEMAN    : MANUEL     VICTORIA   SHANA      DARIN     
ESTEBAN    : JOSE       TORRES     OTTO       BRIGGS    
GRACE      : HERMINIA   ELLIOTT    ANGELITA   HARPER    
ADAMS      : MERCADO    SWEET      RUSS       BATTLE     CHUCK     
RICKY      : TABATHA    DARNELL    HENSLEY    FLORINE    TAMMY      IRVIN      REINALDO  
LORENA     : LEACH      DENA       CAMERON   
KARLA      : HANSON     LELIA      LOTT       MCBRIDE   
WOODARD    : KNOWLES    WELCH      JACOBS     TAMMIE     CHARLES   
JARED      : DONOVAN    FREDERIC   RIOS       RICHMOND   ROSEMARY  
WELLS      : FRIEDA     SHIRLEY    THADDEUS  
NEWTON     : CHANEY     BLACKWELL  BOYLE     
BURRIS     : JEREMY     DONALD     VARGAS     DALTON     ALFONSO    MACIAS    
MARCY      : MONTGOMERY JESSE     
BENITO     : LOIS       SOLIS      TANNER    
LARSON     : MARIANA    MOISES     ALBERTO    ROTH      
VICKI      : SERGIO     FREDRIC    AHMED     
DONALD     : HANNAH     STEFANIE   FLORES     RICARDO    BURRIS     WHITE      HEWITT    
WENDY      : BARRY      BURTON     SAMPSON    GREENE    
AUBREY     : CARSON     DOROTHEA   LATISHA    TOWNSEND  
DAVID      : HOBBS      CONLEY     WEEKS      JOSUE      ELVA      
COMPTON    : VALERIE    BRIGHT     JEREMY     ALEXANDRA 
PUGH       : HERRERA    LEVI       REINALDO  
MENDOZA    : STEFANIE   BOOTH      DIXIE      SHELLEY   
KEITH      : BAIRD      MARCI      DOMINGO    REESE      RUSSEL     PARKS     
MERLE      : ALVAREZ    JOSUE      GENARO     RICHARDSON
BREWER     : KRISTIE    ESMERALDA  REINALDO   PHELPS    
VERNON     : RICARDO    RUSSELL    MABEL      ERICKSON   GALLOWAY  
SCOTTIE    : HERBERT    MCCONNELL  JUANITA   
ALICIA     : WOODWARD   VIRGIE     HUDSON    
EARLE      : ELISEO     JOSUE      SUSIE      NATASHA   
IAN        : BRADLY     PAM        JOSE       ELIJAH     TONIA     
JEAN       : MCKEE      NIGEL      WHITFIELD  ANTHONY    HODGE     
SAUNDERS   : PICKETT    WEEKS      ANTHONY    BATTLE    
DECKER     : JOHNS      ELLIS      CRAFT      LEONEL     PEREZ     
JOSUE      : WITT       SAM        BONITA     PARRISH    DAVID      MERLE      EARLE     
SYKES      : CASTILLO   ROSALIE    WELCH      LAUREL     DEMETRIUS 
MILDRED    : ISABELLE   KATHY      MASSEY     TIMMY      JESSICA    ANTONIO    TRAVIS     GLOVER    
SYBIL      : BURCH      DELORIS    CHERRY     WHITNEY    VARGAS    
DEANNE     : MYERS      ANTONIO    CHARLENE  
BONNER     : JANELLE    RIOS       EVANGELINE
NIELSEN    : TRENTON    WELCH      GERARDO    OLSON     
ENGLISH    : BRENDAN    FANNIE     MCCALL     BUDDY      HALL       LEON      
HOUSE      : KENDRA     BRYANT    
LEONARD    : WEBSTER    VASQUEZ    LOURDES    ALFRED     JOHNSON   
WATERS     : MERCADO    BERTIE     GREGORY   
BENTON     : REEVES     VICKY      LEBLANC    MERLIN     SHIRLEY    ERICKA     CEDRIC    
HARMON     : MEREDITH   CHUCK      NELDA      REGINA    
DIXON      : CHANCE     CORTEZ     MARCEL    
ISABELLA   : HERBERT    NORRIS     GOODMAN    MORENO     HEWITT    
GARNER     : ROSALIE    STEPHENS   SHANNON    HARRIET   
MOODY      : HICKS      AURORA     ROBERTSON 
LUISA      : SPENCE     MCCRAY     ELLIOTT    ELINOR    
PUCKETT    : BAKER      VONDA      RICHARDS   BLANCHARD  RAYMOND    ERMA       CANTU      FREDERICK 
WALL       : BALDWIN    WINTERS    LEWIS      SHAWN      HICKS      MACDONALD  PHELPS    
DEMETRIUS  : MCLEOD     SYKES      ANDREW    
MOHAMED    : LAUREN     BRIAN      CHANDLER   SHERMAN    STRONG     NATASHA   
GIBSON     : NEWMAN     JORDAN     ENRIQUE    MOLINA     VIRGIE     ERIK      
SOLOMON    : ROSETTA    IVANA      MOLLIE     EARL       QUINN     
GOOD       : ROSETTA    ISSAC      BERT       MUELLER   
ELVA       : ROBERTA    BARRERA    DAVID      DAVENPORT 
NIEVES     : CRYSTAL    HOUSTON    ROBBY      BOWMAN     JEANNE     JAMEL     
JEWELL     : MARIBEL    WILL       DEWITT    
JOSE       : TRENTON    RYAN       ESTEBAN    IAN       
DIXIE      : HUNTER     MENDOZA    GALLAGHER 
GRAY       : FORBES     GILL       ROXANNE    HENDRIX    TERENCE   
FULLER     : BENJAMIN   BALDWIN    CLEMONS   
ELDON      : SAM        BRIDGET    ALBERT    
JESSICA    : ERIKA      GEORGE     MILDRED    CHARMAINE 
GILLESPIE  : MCKENZIE   CARMELO    BOWMAN    
ALEXANDRA  : MARA       COMPTON   
IRA        : MARK       ROBT       JESSE      AVERY      RORY      
BIRD       : MILLICENT  ELISEO     FRANCESCA  BILLIE    
TAMMIE     : SOTO       HERMINIA   WOODARD   
RORY       : SIMONE     IRA        GENARO     SUSIE     
MERCER     : KNOWLES    OMAR       WILLIE    
STANTON    : VERA       SYDNEY     AUGUSTINE  COTTON    
GRACIELA   : LATISHA    SALINAS    BLAKE     
COLLIN     : JILL       TOMMY      CARR       KIDD       MAURICE   
BOBBI      : KENNEDY    ENID      
MARKS      : BERTIE     NORRIS    
ADKINS     : JONI       HENRIETTA  COFFEY     HARRIS     DANIAL    
HERMAN     : TAMMI      TERRI     
IRVIN      : THELMA     FLORES     RICKY     
PATRICK    : SPENCE     SILVA      VINCENT    MORROW    
VALENZUELA : CLAUDETTE  CROSS      PAT       
WILKERSON  : BERNADETTE NADINE     PALMER    
ANTONIO    : KATHERINE  MAYS       MILDRED    DEANNE     SETH       LIDIA     
HERSCHEL   : TOM        VALENCIA   AUTUMN     MUNOZ     
DWIGHT     : LANA       VICKY     
HURST      : MARIE      HEAD       HILL      
PAT        : TAYLOR     SWANSON    VALENZUELA FREDERICK 
LAURI      : MCKENZIE   MCFADDEN   PARK       SOFIA     
HENRY      : AVIS       ANIBAL     MARIBEL    GUY        YOUNG      DORA      
MARSH      : EDITH      BURTON     FLEMING    MUNOZ     
NOEMI      : MARISOL    ROMERO     PAM        DYER       RICHARDSON
CHRISTIAN  : HATFIELD   DERICK     ESTES      POLLARD   
SHANNON    : MARIA      ERIKA      GARNER    
ARNULFO    : FRANCESCA  FRANCIS   
SETH       : GINGER     CALDWELL   ANTONIO    RUSSO      BEASLEY   
INGRAM     : FRY        ROY        MOSS       ESMERALDA  PATSY     
ALFRED     : BALDWIN    JACLYN     TAMMI      LEONARD    EVAN      
CHRISTINE  : THURMAN    REGGIE     ALFONSO   
CINDY      : EVANGELINA ALFONZO   
DAVENPORT  : CRAFT      JERALD     ELVA       BRYAN     
SANFORD    : HORN       FRANCESCA  FOSTER     DAMIAN     ROTH       BOWEN      ANNABELLE 
COLEMAN    : FRYE       BROCK      JOHNSTON  
JIM        : AYALA     
GENARO     : JOANNA     STEVENS    MERLE      RORY       ALI       
CORINNE    : ROBERTA    KYLE      
ELBERT     : TREY       HAYS       NORA       JUAREZ    
DAREN      : DOYLE      RODRIQUEZ  BUCKLEY    CONCEPCION HELENA     BRIGGS    
YVETTE     : BURGESS    NITA      
MORROW     : CHAVEZ     PATRICK    TERRENCE   GALLOWAY  
GUZMAN     : MCNEIL     MILLICENT  LULU       FRANCISCO 
NORMA      : WARD       KENT       NORRIS    
DAMIAN     : MILAGROS   LUNA       LORENZO    MERLIN     CALLAHAN   CAROLINE   SANFORD   
HUMBERTO   : TRAN       ISIAH      WINFRED    BERNADINE 
DICK       : GLADYS     MERRITT    CHARLENE  
SONNY      : EUGENIA    CAMACHO    HECTOR    
MATHIS     : JANELLE    BETTE      GINGER     MCCRAY    
JULIET     : FOX        CLEMENTS   HUGH       CATHERINE  SANDOVAL   GREENE    
KRISTEN    : PENNINGTON VAUGHN    
SARGENT    : LENARD     LEACH      ALFONSO   
MCCARTY    : ROB        PITTMAN    GONZALO    JUAREZ     CALVIN    
TANIA      : TATE       FRANKIE   
JULIE      : HERRERA    ROBBY     
RONNY      : AGNES      LANE       RODRIGUEZ 
HENDRICKS  : ISIDRO     LORNA      MINNIE    
BOWMAN     : JULIO      WOODWARD   NIEVES     GILLESPIE 
HARRISON   : TAYLOR     MALLORY    LON       
DORA       : BRYON      PETER      HENRY      BLAIR     
ELIJAH     : WALTON     HUGHES     KELLEY     IAN        GOODWIN    CONSUELO  
ERICKSON   : HUGHES     FLOYD      CLARA      VERNON     CHARLENE   ANNABELLE 
TEDDY      : BEAN       MALDONADO 
REFUGIO    : LANGLEY    KATHARINE  WILLIAMS   STEPHENSON
LOTT       : KATY       GLENN      TILLMAN    KARLA      ROWE      
WATTS      : HOUSTON    CHANDLER   TERRY     
GILES      : STACI      DUFFY      PALMER    
VAN        : MOLLIE     GONZALES   PETERSEN  
BULLOCK    : VALENTINE 
GOODWIN    : GLORIA     ELIJAH    
TORRES     : GERARDO    ESTEBAN    MILO       VAUGHN    
WALLER     : SHAWN      RAPHAEL    GAY       
RAPHAEL    : CONCEPCION WALLER     RANDOLPH  
ELLIOTT    : EMILE      NORRIS     GRACE      LUISA      TERRENCE  
MACDONALD  : FISCHER    CAROLINE   WALL       ADDIE      NOEL      
JAMAR      : HOLDEN     HEATH      THURMAN    ROSA       BARTON     CAROLE    
LEMUEL     : FREDERIC   ISSAC      KERI       ERMA      
DARIN      : ANDERSON   PATEL      FREEMAN   
ROJAS      : CONRAD     MEADOWS    HAWKINS   
BOYLE      : NEWTON    
KENTON     : AMIE       ROSALIE    ALISSA    
MOISES     : VONDA      AL         LARSON    
AUTUMN     : ERIN       HERSCHEL   CORNELIUS 
ROOSEVELT  : ROSEANN   
QUINN      : MCLAUGHLIN TUCKER     BROCK      SOLOMON   
NAVARRO    : PHOEBE     FRIEDA     NIGEL      OMAR       ROYCE      JOSEPHINE 
FAITH      : MARIANO    HOLLOWAY   CASSIE    
CAIN       : JEFFERSON  JULIA      ROSEANN    LOWE       MILLS      LAWANDA   
CHANCE     : WITT       TREY       MYERS      DIXON      QUINTON   
BRANDI     : MOSLEY     MCCLURE   
ROSALINDA  : ANNABELLE 
PATSY      : KERI       ELVIRA     INGRAM     SOFIA      RAUL      
SOSA       : PAMELA     GARTH      HOWARD    
HODGE      : REBEKAH    CAMACHO    JEAN       RUSSEL    
NANCY      : JACOB      ALI       
LON        : ABRAHAM    TAMMI      HARRISON   DUNCAN     GATES     
TERRELL    : WELCH      SCHROEDER  VARGAS    
MERRITT    : BERT       ROCCO      MONTOYA    KAUFMAN    DICK      
MATTHEWS   : MARGUERITE BALLARD    FORBES     CARMELO    MCBRIDE   
CEDRIC     : KIDD       BENTON    
MAXINE     : SANTIAGO   HUNTER     BRANDY    
SUSIE      : VERN       EARLE      RORY       HAWKINS   
HALL       : ETTA       ENGLISH    LINDSEY   
ALYSON     : CARNEY     BERT       NEWMAN     MCFADDEN   KENDALL    MILLIE     HEAD      
CHERRY     : DORIS      ALTON      BONITA     GABRIELA   SYBIL     
CORTEZ     : KURT       DIXON      HELENA     CAROLE    
EVAN       : MCKAY      JONI       ALFRED    
PHILLIP    : MARCI      CASEY     
SUSANNA    : DERICK     DARRELL    AUGUSTINE 
MANNING    : NICOLAS    SERRANO    ROYCE     
CARDENAS   : HARRIS     PARSONS    EVE       
OTTO       : ESTEBAN   
KYLE       : LANCASTER  CORINNE    JOYNER    
EARNEST    : NOE        VERN       THADDEUS  
OLSEN      : CLAYTON    LYDIA      MAE        BURKS      MAYNARD   
WILLIE     : XAVIER     SIMS       MYRA       MERCER     OBRIEN    
SCHROEDER  : MARYELLEN  DOMINGO    SIMS       TERRELL    DON       
TONI       : GOMEZ     
BILLIE     : SWEET      PHILLIPS   FRANCESCA  KEVEN      GLORIA     BIRD      
OLSON      : ELIZA      NIELSEN    CORRINE    ELINOR    
ESTELLA    : BAIRD      MARIBEL    BERTIE    
ALBERTO    : MCCRAY     LARSON     AIDA      
SHARRON    : SELENA     LOURDES   
EDWIN      : DINO       ALTON      MCCULLOUGH EFREN      COFFEY    
WHITNEY    : SYBIL      ROBERT     ERNIE      BRYANT     RUSSO      KERR      
CURRY      : LESLIE     ANDREA     DONNY      KERI       RANDALL    FLYNN      GRAHAM    
HUFFMAN    : DARYL      GARZA     
TERENCE    : ALBA       JOYCE      DONNA      RICARDO    CONRAD     GRAY      
SANTANA    : HINES      MUNOZ      HOOD       STRONG     HILL      
ROMAN      : ALTA       CONCEPCION JAYNE      MAYER     
KENDRA     : HOUSE      CHARLES   
PETERSON   : ALBA       AGNES      DANIELLE   GENEVA     BATTLE    
ROD        : VONDA      CARLENE    MILLIE     MICHEAL    MCCORMICK  EMILY     
BASIL      : HANSON     HUDSON     JOHNNIE   
RICK       : BENTLEY    KEVIN     
MICHAEL    : CONRAD     ROBERT     ROSALES   
BATTLE     : BROWN      ADAMS      SAUNDERS   PETERSON   JULIAN    
COTTON     : PEARSON    VONDA      RITA       STANTON   
BERNARDO   : RAMIRO     GIOVANNI   ROBIN      HICKS      JUANITA    SALVATORE  NGUYEN    
WASHINGTON : WISE       MARIANO    LEON       OBRIEN    
JILLIAN    : CATHERINE  CLARENCE  
TERRENCE   : GIOVANNI   JONI       MORROW     ELLIOTT    CARLA     
HERRING    : SYDNEY     FROST      DAVIS      BAUER     
FREDERICK  : BALLARD    PUCKETT    PAT        REINALDO   CURTIS    
DYLAN      : WELCH     
SIMPSON    : DEENA      CLARENCE   LOGAN      BAUER     
BRADFORD   : JEFFERSON  LULU       CARR       HEWITT    
ERIK       : FOX        VIRGIE     GIBSON    
CALVIN     : LEONOR     BELL       PENNINGTON FORBES     MCCARTY    KASEY     
MARIANO    : WALTON     CHANEY     CLEVELAND  FAITH      WASHINGTON
BARR       : CLAYTON    ALI        DANIAL     SHERRI    
ORTIZ      : MCCULLOUGH GILBERTO  
DON        : LUCILLE    ROY        SCHROEDER 
THADDEUS   : MCCARTHY   WELLS      EARNEST   
SCHWARTZ   : BURT       ROY        HENRIETTA  RUSSEL    
AYALA      : BRIDGETTE  FLORINE    JIM        SALVATORE 
HUDSON     : LUPE       CONTRERAS  EARLENE    ALICIA     BASIL      ARTHUR    
TRUDY      : CANTRELL   KERI       MIKE       FREDRIC    BERNADETTE
ARTHUR     : SIMON      GRIFFIN    HANEY      LOWE       HUDSON    
COFFEY     : BALDWIN    DEENA      LARSEN     ADKINS     EDWIN     
MAYER      : BARKER     BETHANY    ROMAN      HAYDEN    
NADINE     : EDMUND     MARA       SOLIS      SAMPSON    WILKERSON  WONG      
DUNCAN     : GONZALEZ   REYNA      ERNESTINE  LON       
REGGIE     : ODELL      CLARK      DELACRUZ   CHRISTINE  MONA      
BLAIR      : CLEMENTS   STRICKLAND DORA      
SHERMAN    : ANTONE     LANCASTER  MOHAMED    TURNER    
LENORA     : JOHN       KRISTINA   CLAUDIA    MARVIN    
CHUCK      : CHERI      MILLIE     ADAMS      HARMON     BURKS     
GATES      : YOUNG      ALTON      TREVINO    PRISCILLA  LON        CASTRO    
SOFIA      : ANDREWS    LAURI      PATSY      RUSSEL    
FERDINAND  : OLGA       VALERIE    KERI      
ISIDRO     : POTTS      WILBUR     ESMERALDA  DELORIS    HENDRICKS  HARRIET    DANIAL    
KELLER     : HOBBS      RIOS       ASHLEE     HARRIS    
CANDY      : PAGE       BURT       WIGGINS   
JAY        : WILFREDO   HERIBERTO 
TURNER     : TYREE      SHERMAN   
MUNOZ      : COPELAND   MCMILLAN   ORR        HERSCHEL   MARSH      SANTANA   
VARGAS     : MCNEIL     BURRIS     SYBIL      TERRELL   
WENDI      : BRIDGETTE  CORNELIUS  ANDREW    
RANDALL    : CLAUDETTE  CURRY      BAUER     
JOAN       : PERRY      PECK       NANNIE     TRENT     
ERNA       : TAYLOR    
VANCE      : RAMOS      BERTIE    
AMADO      : FIGUEROA   GARZA      JAMEL      LANG       SHELLEY   
CARVER     : PATE       HOMER      CASEY     
LACEY      : ASHLEE    
INA        : FLOSSIE    YOUNG      BURKS      CLAUDIA   
HARRIET    : ROSALIE    GARNER     ISIDRO     CLAUDIA   
AISHA      : GLENN      HAMILTON   CAMACHO    PARRISH   
ALI        : MARGARITA  DEENA      GENARO     NANCY      BARR      
FORREST    : ESTES      ARIEL      WARREN     VELMA     
ADDIE      : ODELL      CORY       RODRIQUEZ  VALENTINE  MACDONALD 
GALLAGHER  : STRICKLAND DOMINGO    DIXIE      MILO      
KNIGHT     : ROMERO     DAWN      
KRISTINE   : AMANDA     BETHANY    ANNETTE    NEIL       MEADOWS   
ROBERT     : KRISTOPHER DALE       ROSEANN    WHITNEY    MICHAEL   
CLARENCE   : JANETTE    JILLIAN    SIMPSON   
WHITE      : MONTY      LENORE     NANETTE    DONALD    
KERRI      : JENNINGS  
HOFFMAN    : FLORINE   
TABITHA    : BENNIE     DENA       FINLEY     NGUYEN    
DURAN      : ESTES      MERCEDES   TASHA      ELISEO    
CORNELIUS  : HORN       LYMAN      HOPKINS    AUTUMN     WENDI     
HOWELL     : ELIZA      LE        
CHARMAINE  : LEONARDO   ERIKA      LACY       JESSICA   
ERNIE      : WHITNEY   
MARSHALL   : STEPHENS   GARTH      TIMOTHY    PRISCILLA 
HOOD       : REYNA      SANTANA   
HARRIS     : DAWN       MCCORMICK  ADKINS     CARDENAS   KELLER     REINALDO   HOGAN     
FRANKIE    : DENA       SEBASTIAN  TANIA      DEAN      
LAWSON     : MARISOL    BEAN       RITA       CARLO     
DEWITT     : PERRY      BEAN       JEWELL    
LEON       : PRISCILLA  ENGLISH    WASHINGTON ALFONSO    LOGAN     
SANCHEZ    : MONTGOMERY ESTES      NITA       JESSE      FRANKLIN  
GONZALES   : DERICK     WINTERS    NEWMAN     BUTLER     CRAIG      VAN       
JEANNE     : HURLEY     BOYD       NIEVES    
LIDIA      : AYERS      ANDREWS    ANTONIO   
CUMMINGS   : PATE       HARDY      NICHOLS    HOLLIE     ROBERTSON 
HAWKINS    : ESTES      INES       DONOVAN    GARTH      DONNY      ROJAS      SUSIE      GALLOWAY  
LE         : DONA       EVERETT    PATEL      HOWELL    
ANASTASIA  : KNOX       WARNER     LUCAS      MCINTYRE   JULIAN     HAYDEN    
ROYCE      : RAYMOND    PRESTON    NAVARRO    MANNING   
BURKS      : ETTA       SHIRLEY    SAMPSON    OLSEN      CHUCK      INA       
FLYNN      : CASANDRA   JOYCE      STARK      VICTORIA   HERMINIA   MARGARITO  CURRY     
DALTON     : BURRIS     LYNN       REGINA    
STRONG     : MOHAMED    SANTANA   
CLINT      : MERCADO    ALFONSO   
LORNA      : RODNEY     HENDRICKS  MONROE    
ENID       : MARISOL    VASQUEZ    SNOW       SAMPSON    BOBBI     
JACKSON    : SOTO       CHARITY    REYES      WALSH      NORRIS     JESSIE     SHARON     STACI     
RICHARDSON : PEARSON    HUGH       SALAZAR    MERLE      NOEMI      SAVAGE    
BRYANT     : VELASQUEZ  BRIAN      HOUSE      WHITNEY   
CLEMONS    : JOHANNA    FULLER    
CHARLENE   : WALTON     MARY       BORIS      LORI       DEANNE     DICK       ERICKSON  
ROWE       : VONDA      JODIE      CONLEY     VEGA       LOTT       NICHOLSON 
REINALDO   : SCOTT      DENA       RICKY      PUGH       BREWER     FREDERICK  HARRIS    
JOHNNIE    : MERCADO    MARCELINO  CHARLOTTE  KRISTOPHER RICO       ROBT       BASIL      GIBBS     
JOHNNIE    : MARCIA    
TANYA      : BENJAMIN   EVERETT    RODERICK  
COTE       : FISCHER    TREY       KOCH      
POOLE      : PHILIP     PARRISH    ODONNELL  
ONEIL      : TARA       GILBERTO   MCCLURE   
HELENA     : HAMILTON   CLEMENTS   DAREN      CORTEZ    
HUBBARD    : TRICIA     LEONARDO   WILFORD   
MARCEL     : WEISS      FRIEDA     DIXON      STEVENSON 
BRAY       : FULTON     GOLDIE     PETERSEN  
DAMON      : GARZA      JANICE    
AIDA       : THELMA     ALBERTO    COLLINS   
BLAKE      : MARISOL    WEBSTER    XAVIER     STEWART    GRACIELA  
GEORGIA    : KRISTIE    SIDNEY     HORN       KOCH       JOHNSON   
NELDA      : JODIE      TIMOTHY    KERI       HARMON     JOYNER    
GRAHAM     : ELLIS      BERT       BRIGITTE   OTIS       JIMMIE     CURRY     
HOWARD     : MEADOWS    SOSA      
STEVENSON  : MARION     KENT       SCOTT      SCHULTZ    WILFORD    MARCEL     FRANKLIN  
STACY      : LUCILLE    SAM        COOKE      BRANDY     PALMER    
CAROL      : KENT       NOE       
MADDEN     : VONDA      KRISTINA   SHERYL     MAE       
ROSALES    : ANTONE     MICHAEL   
ALISSA     : NICOLE     RIOS       KENTON     OBRIEN    
RODERICK   : MARK       SIMON      JERALD     TANYA     
NOEL       : CAROLYN    MACDONALD 
MCLEAN     : DELMAR    
CONSUELO   : MARIA      THOMAS     ELIJAH    
CARLA      : RIVERA     DONNY      TERRENCE   MACIAS    
KASEY      : FARLEY     VALENCIA   CALVIN    
MORENO     : LUCIEN     DENIS      QUINCY     ISABELLA  
BARNETT    : HOLDEN     MARYANNE  
ANDREW     : FOX        CROSS      DEMETRIUS  WENDI      PARKS      WONG      
SAVANNAH   : WILFREDO   KENDALL    DOROTHEA   TONIA     
DUNLAP     : WOLF       EARL       STEPHENSON
MITCHELL   : BLEVINS    MARGERY   
HEWITT     : POTTS      BORIS      LETICIA    DELMAR     DONALD     ISABELLA   BRADFORD  
BARBRA     : HARRINGTON CHARLOTTE  JOHNSON    MARTIN    
JOSH       : HOOPER     BOLTON     DUKE       LANG       TY        
MILO       : WYATT      BOB        CLEVELAND  TORRES     GALLAGHER 
MACK       : OBRIEN    
ODONNELL   : JACKIE     MARCI      MARYELLEN  HUGH       POOLE      OWEN      
JOHNSON    : REBEKAH    LAUREN     CHRISTA    HENRIETTA  LEONARD    GEORGIA    BARBRA    
MINNIE     : MARION     SYDNEY     KRISTIE    CECIL      CONNER     HENDRICKS 
CASTRO     : GATES     
JAMEL      : NIEVES     AMADO      TYLER     
HOLLOWAY   : LILIANA    MERCEDES   BAIRD      BUDDY      FAITH     
LANG       : MCCONNELL  WILL       KENNEDY    CLARA      AMADO      JOSH      
SALVATORE  : MCCARTHY   MICHEAL    BLANCHARD  BERNARDO   AYALA      MARISSA   
RANDOLPH   : DELGADO    RAPHAEL   
TRAVIS     : PATE       LARSEN     MILDRED   
DEVON      : SUAREZ     JOSEPH     SHEPHERD  
FRANCISCO  : BUCK       JUSTINE    PAM        AVA        GUZMAN    
CORRINE    : JAMAAL     BYRD       RICE       OLSON      DUFFY      KRYSTAL   
HOGAN      : LENARD     ISRAEL     LOWE       HARRIS    
DANIEL     : FOWLER     HERIBERTO 
ANGELITA   : DEJESUS    FRANCES    GRACE     
MARISSA    : HART       HAROLD     SALVATORE  LAWANDA    KERR      
OBRIEN     : DAWN       WILLIE     WASHINGTON ALISSA     MACK      
WINFRED    : MAC        LAMBERT    WILKINSON  HOMER      HUMBERTO   ROBERTSON 
CLAUDIA    : JAMAAL     LENORA     INA        HARRIET   
GIBBS      : BALLARD    PARK       FERN       JOHNNIE   
FERRELL    : WALSH      BEACH     
ELINOR     : MARYANNE   CARLENE    KURT       LUISA      OLSON      BARTON    
LUCY       : LETITIA    LEONOR     COOK       VICTOR     JOSEPHINE  JOHNSTON  
GAY        : NUNEZ      TUCKER     RONALD     HERIBERTO  WALLER    
MOSLEY     : ODESSA     PIERCE     BRANDI    
FUENTES    : DUNN       SOLIS      TAMMY     
JULIAN     : AGNES      FREDRIC    PARRISH    BATTLE     ANASTASIA  LYNN      
PASQUALE   : WEEKS     
LEROY      : PORTER     WEBB      
DELBERT    : BURT       RICHARD    DAVIS     
DANIAL     : LATISHA    CRANE      MALLORY    ADKINS     BARR       ISIDRO    
PHELPS     : HOOPER     ANDREA     BREWER     WALL      
MAYNARD    : LAUREN     LOTTIE     OLSEN     
JOYNER     : GARRETT    LENORE     KYLE       NELDA      GILBERTO  
CURTIS     : REEVES     CORY       ANNIE      XAVIER     FREDERICK 
CONSTANCE  : LEACH      JULIA      LINDSAY    BUCKLEY    SHELLEY   
TANNER     : ALEXANDER  BENITO    
KRAMER     : MONTY      CHARITY    MCKEE      COLLIER    JESSIE     ALFONSO   
MCGOWAN    : MAXWELL    LOTTIE     WILKINSON 
SELLERS    : ROBERTA    SERGIO     PACHECO   
SHELLEY    : RASMUSSEN  GEORGE     MENDOZA    AMADO      CONSTANCE 
ALFONSO    : DUNN       BURRIS     CHRISTINE  SARGENT    LEON       CLINT      KRAMER    
CROSBY     : DONOVAN    LENORE    
PARSONS    : GONZALEZ   BENTLEY    FOSTER     MCCORMICK  CARDENAS   PALMER    
HELGA      : LEVI       HARDY      BLEVINS    WYATT      KANE      
ALINE      : ELLIS      MANUEL     RICHMOND   TYLER      WELDON    
GALLOWAY   : MAGGIE     MILES      MARCUS     PRUITT     MASSEY     VERNON     MORROW     HAWKINS   
LINDSEY    : MCDONALD   DELMAR     HALL      
JOSEPHINE  : SHEPARD    NAVARRO    LUCY      
BERNADINE  : BRYON      HUMBERTO  
OWEN       : MAXWELL    TOBY       WILEY      JANETTE    JACOBS     ODONNELL  
CASEY      : JARVIS     HUBER      SUSAN      PHILLIP    CARVER    
TYLER      : JAMEL      ALINE      MONROE    
MARCIA     : BONITA     JOHNNIE   
COLLINS    : LAMBERT    AIDA      
MONROE     : LORNA      TYLER      EVANGELINE RAUL      
MARVIN     : ERICK      TAYLOR     LORENZO    DONNA      FRANCESCA  LENORA    
DUFFY      : LETITIA    DELGADO    GILES      CORRINE   
JOHNSTON   : JACKIE     CHAN       CONNER     NIKKI      COLEMAN    LUCY      
KELLY      : CARLSON   
RUSSO      : REEVES     CLARK      INGRID     MASSEY     RAY        SETH       WHITNEY   
BRIDGET    : KIM        FEDERICO   CLEVELAND  ELDON     
LYNN       : MONTY      HIGGINS    DYER       DALTON     JULIAN    
BEASLEY    : GILL       ENRIQUE    LEVINE     RUSSELL    SETH      
ETHEL      : MARCELINO  OSCAR      GARTH      CONNER    
MACIAS     : SLOAN      ROCKY      BURRIS     CARLA     
FINLEY     : BYRD       TASHA      NORRIS     KAUFMAN    WILKINSON  TABITHA   
BARTON     : SILVA      SIMS       GOODMAN    JAMAR      ELINOR    
RUSSEL     : JOHN       ARRON      BERT       LANGLEY    KEITH      HODGE      SCHWARTZ   SOFIA     
PALMER     : MCCARTHY   WILKERSON  GILES      STACY      PARSONS   
GLOVER     : LAUREN     HICKS      NIKKI      MILDRED   
LAWANDA    : MANN       STACIE     HEIDI      SOLIS      MALLORY    HECTOR     CAIN       MARISSA   
LAWANDA    : KEVIN     
EVE        : CHERI      CARDENAS  
GILBERTO   : ORTIZ      ONEIL      JOYNER     PARKS     
LLOYD      : SARA       CARMELO    ARMSTRONG 
HEAD       : HURST      ALYSON    
PARKS      : KEITH      ANDREW     GILBERTO  
MARTIN     : JAMAAL     HEBERT     ABEL       GUTHRIE    CARROLL    BARBRA    
SAVAGE     : RICO       DONA       MAYS       RICHARDSON
MAURICE    : JILL       COLLIN     REGINA    
STEPHENSON : WILL       THOMPSON   REFUGIO    DUNLAP    
NICHOLSON  : REEVES     ART        ROWE      
BRIGGS     : BETTE      ESTEBAN    DAREN     
REYNOLDS   : PICKETT    ARRON      GOLDIE     DARRYL    
REILLY     : AVIS       HANEY      DUSTY      AVA       
EVANGELINE : HOBBS      MCKEE      LOURDES    ASHLEE     BONNER     MONROE    
BRYAN      : DONOVAN    BERT       TATE       BERNADETTE DAVENPORT 
NGUYEN     : DEANDRE    WEAVER     GEORGE     BERNARDO   TABITHA   
WEBB       : HENSON     LEROY     
ROTH       : LARSON     SANFORD   
KANE       : BENJAMIN   VERA       WILFORD    HELGA     
ALBERT     : ERIN       HUGH       ELDON     
LESSIE     : RUSS       HAZEL     
ANGIE      : DEENA      CARSON     MORRIS     FULTON     MEADOWS    ROBERTSON 
DEAN       : CLAUDETTE  SNOW       VEGA       FRANKIE   
MCCLURE    : LORRAINE   RICHARDS   SHAWN      BRANDI     ONEIL     
STANLEY    : RENA      
MCBRIDE    : LANE       OMAR       EARLENE    KARLA      MATTHEWS  
HUNT       : BARRERA    HENSON     MARY       KIDD      
BETH       : RAMIRO     ODELL      JAIME     
RENA       : GILMORE    NICOLE     YOUNG      BOWERS     FOWLER     STANLEY   
ROBERTSON  : CANTRELL   MOODY      CUMMINGS   WINFRED    ANGIE     
KEVIN      : BELL       AUSTIN     PORTER     RICK       LAWANDA   
KRYSTAL    : PRINCE     BRENDAN    FREDERIC   DEENA      BEACH      CORRINE   
WELDON     : GLENN      FROST      ALTA       BROCK      BRIGHT     KATHLEEN   ALINE     
ESTRADA    : CHRISTA    AMELIA    
GREENE     : COOK       SHARON     WENDY      JULIET    
MCMAHON    : MERCADO    SANTIAGO  
TRENT      : BERT       MARIE      JOAN      
REGINA     : KRISTIE    MARCI      SCHULTZ    JASPER     FERN       HARMON     DALTON     MAURICE   
POLLARD    : BALDWIN    DYER       CHRISTIAN 
QUINTON    : CHANCE     DARRYL    
CAROLE     : JAMAR      CORTEZ    
HOLLAND    : STEPHENS   DALE      
KERR       : WALTERS    HART       MOLLIE     HECTOR     JAYNE      WHITNEY    MARISSA   
DARRYL     : JENNINGS   MALDONADO  ROSEANN    REYNOLDS   QUINTON   
CHARLES    : MEADOWS    WOODARD    KENDRA    
LOGAN      : SHEPARD    RAY        VALENTINE  SIMPSON    LEON      
CASSIE     : HARDY      BROWN      STEVEN     AHMED      FAITH     
BOWEN      : GRIMES     TOBY       CHANG      PHILIP     JANINE     SANFORD   
HARPER     : VILMA      STEPHENS   GRACE     
FRANKLIN   : PETTY      SANCHEZ    STEVENSON 
WONG       : CARLSON    ANIBAL     ETTA       DUKE       NADINE     ANDREW    
MERRILL    : MARCELINO  JEFFERSON  DELANEY   
MONA       : HATFIELD   ISSAC      HOLT       REGGIE    
TONIA      : IAN        SAVANNAH  
DANA       : SWEET      JOHNS      TYREE      EDITH      PARK       QUINCY    
ANNABELLE  : LAUREL     RYAN       SANFORD    ERICKSON   ROSALINDA 
TY         : MAGGIE     JOSH      
HILL       : ANIBAL     CLEMENTS   HURST      SANTANA   
BAUER      : SCHNEIDER  LEWIS      BOWERS     DELORIS    HERRING    SIMPSON    RANDALL   
TRACY      : IVANA      ASHLEE    
HAYDEN     : WALTERS    BEST       FOWLER     WILKINSON  MAYER      ANASTASIA 
NATASHA    : ROSA       EARLE      MOHAMED   
RAUL       : FEDERICO   PATSY      MONROE    
VAUGHN     : LESLIE     ARRON      TATE       KRISTEN    TORRES    
LORAINE    : EUGENIA    HEBERT     FLOYD      KLINE      PRESTON    ERMA      
RACHAEL    : KIM        JOY        LES        ANNETTE   
SHERRI     : CASANDRA   BARR      
PETERSEN   : LATONYA    FRANCIS    VAN        BRAY      
