OLGA       : ROSARIO NANCY 
ROB        : KRISTINE MERLE WEBER 
DORIS      : NORMA RANDOLPH 
WILLARD    : BOWERS NUNEZ HOLLAND 
COLON      : GILLESPIE HUBER COLLIER 
MAVIS      : TRAVIS MARGERY DINO 
LANDON     : TONI MERCADO 
KATHERINE  : MCCRAY JUAREZ AMELIA 
PAGE       : BELL 
HOOPER     : FREDERICK DAPHNE SHELLEY 
OLIVER     : MACIAS 
CASTILLO   : HOOPER BONNER 
TRENTON    : ROSETTA ESTRADA 
RAMSEY     : HICKS DONA KEITH 
VILMA      : JESSICA BOYER 
MCDONALD   : VONDA KATY TODD 
PEARSON    : DELACRUZ GIOVANNI BLACKWELL 
WALTON     : CALLAHAN HUDSON WENDY 
CARLSON    : DELANEY JOHNSTON BENNIE 
MARISOL    : NOEL HENRY DIONNE 
LESTER     : DUNN FLETCHER LESSIE 
MANN       : TYREE 
PERRY      : INGRAM CLEMENTS RODGERS 
KATY       : HUGH 
MARK       : CANDICE 
ANTONE     : MARGARITO 
JOHN       : CECELIA RUSS REEVES 
MAXWELL    : LES 
ANNA       : DUFFY KURT 
LETITIA    : EMORY NIKKI 
VALERIE    : NOE ALEXANDRA 
MCKAY      : VICTORIA 
PRINCE     : SONYA DUSTY SHEPHERD 
LUCIEN     : EMILY 
CHANEY     : FAULKNER 
GILMORE    : BENJAMIN GIBSON 
LESLIE     : GLOVER ELLIS ISIDRO 
MARION     : RICK 
GLENN      : COFFEY DELGADO 
LEE        : LEMUEL 
HATFIELD   : CAROLYN DEANA CHRISTI 
CRYSTAL    : WOODARD CECELIA PHILLIP 
LUCILLE    : SERRANO TASHA 
PATE       : GRACE HARRIS 
MONICA     : HARRIET 
LENARD     : STUART 
RAMIRO     : JIMENEZ DURAN 
PHOEBE     : ROSALINDA BARRERA 
FOX        : GLORIA LINDSAY CRAFT 
ROBERTA    : MOHAMED RICARDO BYRD 
BENJAMIN   : CAIN 
LEONOR     : DARIN 
TILLMAN    : STOUT GINGER 
AVIS       : JOHNSON WYATT CHELSEA 
ANDERSON   : LESTER DAVID 
JENNINGS   : TRAVIS 
LATONYA    : DIXON VILMA 
ODESSA     : HELGA 
LILIANA    : FANNIE GONZALO 
LITTLE     : JESSICA 
MADELINE   : MUNOZ TRUDY 
PERCY      : MILLIE 
WARD       : ERMA ARIEL JESSIE 
KNOX       : CARISSA DAWN 
FIELDS     : HUMBERTO ALFONZO 
AMIE       : VALENZUELA JANELLE 
WITT       : RUSSEL MARTIN 
CANDICE    : MILAGROS 
MONTGOMERY : WEAVER 
JANELLE    : TINA 
HOLDEN     : CURRY LACEY TORRES 
DERICK     : DONALD CAMERON COMBS 
MEREDITH   : MCCULLOUGH 
WALTERS    : TATE TABATHA HIRAM 
ABE        : TRAN REINALDO 
JACKIE     : SANTIAGO MERRITT LANGLEY 
COPELAND   : WILL 
ESTES      : CARROLL 
HERRERA    : HERSCHEL 
THELMA     : ADELINE TAMMIE JILL 
MILAGROS   : PASQUALE 
ARIEL      : AUSTIN GARTH 
MERCADO    : LEMUEL GUZMAN WILCOX 
MCNEIL     : CORRINE RAMOS HOMER 
SIMON      : OTIS CORY VASQUEZ 
TODD       : BARR HOLT FLETCHER 
MARCELINO  : FERDINAND STACY 
WILCOX     : TRAVIS 
LEACH      : VILMA ENID CINDY 
IRIS       : MCFADDEN ANIBAL 
INES       : BOLTON 
WEBSTER    : EVANGELINE GENARO MARA 
RAMOS      : JOHANNA 
BLACKWELL  : HICKS GUY JARVIS 
ANIBAL     : HAWKINS 
DONOVAN    : HILL 
LILA       : WINFRED HIGGINS 
HOBBS      : SONNY NIKKI 
STACIE     : WEBSTER DUKE DORIS 
CHRISTI    : AMANDA 
LOIS       : WILKERSON 
JAMAAL     : GOODMAN CLARK PHOEBE 
BALDWIN    : PAULETTE 
MONTY      : LORRAINE SNOW 
HARRINGTON : CROSBY 
PICKETT    : ALTA 
EUGENIA    : JANELLE EDMUND MARTINEZ 
SAM        : MAC AVIS BETTE 
OCTAVIO    : NEIL 
HAMILTON   : WASHINGTON 
CRISTINA   : ROBBY MUELLER HUBER 
BRENDAN    : BORIS WYATT 
BARRY      : TRENT JOSUE 
WARREN     : LYMAN 
HANNAH     : DOROTHEA CAROLYN 
ERIN       : SANTANA CAMERON BURKS 
HOUSTON    : SAMPSON PRUITT ADELINE 
BELL       : MONTGOMERY RACHAEL 
SWEET      : TONI 
BARLOW     : WALTERS TERRY 
DUNN       : LARSEN 
LANA       : LENARD CAMACHO 
YANG       : DECKER JASPER 
ANDY       : BOWERS 
HIRAM      : GILBERT SANCHEZ HURLEY 
CONNIE     : DUSTY ODELL MURIEL 
BARNES     : WEEKS 
JEFFERSON  : ETTA 
PAMELA     : HARRISON WILL ARNULFO 
MERCEDES   : DONOVAN 
HORTON     : JEREMY BARRY 
HERBERT    : LEONARDO JIM LORENZO 
BARRERA    : KEITH PAGE OLGA 
MCCONNELL  : LOURDES WILBUR MILLS 
ROSALIE    : ROCCO VALERIE 
CHARLOTTE  : HENRIETTA FERN 
JILL       : MAGGIE NOELLE RYAN 
MAC        : MAGGIE BALLARD VICKI 
WALDO      : OLSEN CHARMAINE MILES 
LEVI       : ALFRED BUCKLEY JANICE 
WARNER     : ALICIA BENTON 
HARRELL    : ALICIA 
GOMEZ      : KRISTINE 
SOTO       : DONALD 
ABRAHAM    : BARTON HARMON 
JIMENEZ    : STEVENSON HUNTER 
ALLISON    : TATE 
BUCKNER    : GILBERT MURIEL 
FREDERIC   : ORR ISIAH 
COMBS      : REYES VERN 
DODSON     : LATONYA 
REBEKAH    : ARIEL HERRERA 
ROSETTA    : GRIMES MCCARTY ODELL 
HARDY      : NOE LOGAN 
VELASQUEZ  : LYNN 
WEBER      : BRANDY WALTERS 
BAIRD      : DEENA WHITAKER SIMS 
ALEXANDER  : ELISEO 
BRYON      : AUBREY 
MARGARITA  : ANIBAL 
OCONNOR    : ROWE 
ALVIN      : JEAN BURTON 
FOREST     : DEWAYNE DEWITT 
CHARITY    : DIANE OLIVER ED 
COOKE      : BRANDY WELCH 
DIONNE     : EMORY 
TRICIA     : MAGGIE SUSAN 
VERA       : WILBUR CARLSON JACKSON 
NUNEZ      : MORROW DIXIE LEONARD 
ALBA       : DAWN MICAH TILLMAN 
ISSAC      : HEWITT GRIFFIN 
FLOSSIE    : WELLS 
ELMA       : DALE GONZALO 
BLEVINS    : LENORA WILLIE BLACKWELL 
BUCK       : GLOVER 
NICOLE     : JOSE MALLORY 
MCMILLAN   : AURORA 
REEVES     : MARIA ASHLEE ARMSTRONG 
BYRD       : MCCARTY WEBER CASANDRA 
MOSES      : STEVEN VICTOR AHMED 
IRWIN      : ART MORROW 
CAITLIN    : BRIGITTE ESMERALDA MAXWELL 
STEPHENS   : CLEMENTS KNIGHT 
SYDNEY     : ERICK LOTTIE 
DINO       : CRISTINA 
CLEMENTS   : AURELIA WALLER 
MCCARTHY   : KNOX DALE GARZA 
OSCAR      : POLLARD 
GRIFFIN    : SHEPHERD 
LUNA       : CHARLIE BARBER 
MCKEE      : TUCKER DAPHNE 
IVANA      : GRETA 
BAKER      : BARNETT CAMACHO 
DEENA      : GOOD CLEVELAND 
WINTERS    : MCMILLAN TANIA 
EMORY      : BARLOW NEWMAN WALLS 
ROBBIE     : RAUL 
WEISS      : WALTERS 
LAUREN     : REGINA CAMERON ALBERTO 
ODELL      : ANDREWS 
KNOWLES    : WHITE DELGADO 
ROBBY      : FOSTER 
STUART     : MASSEY 
OLA        : JULIA 
GARTH      : MCCULLOUGH 
BEAN       : EFREN 
ANITA      : LETITIA CHRISTIAN 
VELMA      : LANA DYLAN HUGHES 
KRISTIE    : THADDEUS WENDY IRWIN 
ARRON      : MICHEAL 
JOHANNA    : ANDREA GARNER BURGESS 
BETTE      : MCINTYRE LENARD BETH 
ROBINSON   : CASSIE 
TABATHA    : GILES COTE 
GRIMES     : DEJESUS MARGARITA KOCH 
DARNELL    : LAMBERT TERRI 
GILBERT    : HARRISON 
PITTS      : ANTONIO GALLOWAY 
SANTIAGO   : PALMER ANNA 
CLAYTON    : PAT FUENTES SIMPSON 
GARRETT    : LEE NATASHA ROXANNE 
MARIA      : LAUREL BEST 
FISCHER    : ROCKY ANDY 
CARNEY     : ANNMARIE 
DILLON     : TOWNSEND JAMEL EARLE 
CASE       : GILLESPIE FREDERIC RONNY 
PITTMAN    : BUCKNER BLAKE 
SCHNEIDER  : BRIAN MARYANNE 
WYATT      : MARCUS 
MCLEOD     : SCHNEIDER 
MCLAUGHLIN : JOSEPH 
WELCH      : ELDON 
MCKENZIE   : GILES CAROLINE FINLEY 
HART       : WEBSTER 
SPENCE     : KURT DEWITT 
PENNINGTON : WILBUR 
JOHNS      : OBRIEN WOODWARD 
HANSON     : MARK 
NOLAN      : DEJESUS VALENTINE 
DEJESUS    : SUSAN 
BURT       : HERBERT 
HUNTER     : DIXIE HOLT 
MICAH      : FERDINAND SHELLEY 
FANNIE     : LORIE VELASQUEZ IRA 
CORY       : MILAGROS ALBA 
REYES      : MERCEDES TIMMY 
URSULA     : KENNEDY 
JARVIS     : MAC JODIE POOLE 
JUSTINE    : MCCARTY HOPKINS MCINTYRE 
MARIBEL    : ERICK LUCIEN MONA 
RODNEY     : ROBBY HARDY 
HEBERT     : NORRIS LINDSEY CARSON 
SILVA      : NELDA CHERRY 
JACLYN     : RITA FRANKS JIMENEZ 
PHILLIPS   : VARGAS VERA ROTH 
TOBY       : SAUNDERS 
GONZALEZ   : STEVENSON 
ELLIS      : JOHNSTON 
CHARLIE    : MARIANO BAUER TARA 
HOLMAN     : MARK 
EDMUND     : TUCKER 
FRY        : AYALA 
CARSON     : RAMOS NOLAN 
HUGHES     : JOYNER 
BURGESS    : CORRINE 
AUSTIN     : GALLOWAY ERMA 
PIERCE     : TRENT MARCUS JEREMY 
DENIS      : ARIEL LEONARDO RANDOLPH 
CHANG      : LEANNE STRICKLAND CARLA 
HINES      : LEWIS MCMILLAN 
TRACEY     : KENTON WENDI TAMMIE 
DARYL      : BLACKWELL 
DIAZ       : CONRAD BALLARD 
CECELIA    : REUBEN PATSY HARDY 
LARSEN     : GILLESPIE 
RICE       : ELBERT HARRELL FREEMAN 
BRIAN      : LYNN 
JOHNATHAN  : DANA ERNIE JERALD 
BENNIE     : VERA 
ERICK      : SOTO FLYNN BAUER 
LEANNE     : BUCHANAN NICOLAS COLEMAN 
KENT       : CURRY 
COOLEY     : SAMUEL CRYSTAL 
TASHA      : BURGESS ELOISE 
BERT       : CORRINE RONALD FLORES 
GUY        : CONSTANCE COLLINS 
CLARK      : ROWE JAMAAL AYALA 
TUCKER     : SIMONE FRANCISCO 
VONDA      : FRANCES RAMSEY 
FROST      : ANGELITA 
NORTON     : CANTU 
CRAFT      : KENTON MABEL RUSSEL 
LYDIA      : DANA 
FRYE       : QUINTON 
SELENA     : HARRELL ANDY 
BRIDGETTE  : BRIANA LEON WILLIAMS 
WOLF       : AGNES HENDRIX 
THOMAS     : BRADLY 
YOUNG      : BEST SHERYL 
DEANDRE    : LAUREL 
KIM        : HECTOR RUSSELL MCLAUGHLIN 
ENGLAND    : REEVES 
CHELSEA    : COLLIER 
AGNES      : WATTS KERI 
SILAS      : CAROLINE CARDENAS THADDEUS 
MAGGIE     : ROWE KERI 
HIGGINS    : ANITA GLOVER SHEPARD 
TYREE      : FERDINAND MONTY CLEMENTS 
ELOISE     : ADDIE ROBT 
TOM        : VASQUEZ TUCKER CRISTINA 
MARGUERITE : MARA PAT LEON 
DEWAYNE    : GINGER ANTONE HINTON 
FLOYD      : HUNTER 
RICHARD    : WEBSTER 
EDITH      : REEVES 
WHITAKER   : TONI 
ANNIE      : CATHRYN CARNEY WILKERSON 
FLETCHER   : FOWLER FRYE MERCADO 
CHRISTA    : MONTGOMERY RAMSEY 
LEONARDO   : ART KIM 
LANGLEY    : ANIBAL 
STEFANIE   : HUGHES DANIAL HERSCHEL 
STEELE     : MONROE CRANE 
BARTLETT   : BERNADETTE ALINE JERALD 
KLINE      : MERCADO WINFRED LYDIA 
KRISTOPHER : MICHEAL CHARMAINE 
ETTA       : FERDINAND BRANDY COMPTON 
ISABELLE   : CORY DWIGHT 
AMELIA     : KAUFMAN RUSSELL STEVENS 
TARA       : MCCORMICK 
ALTON      : FAITH 
BALLARD    : OLSON GIBBS ROSALES 
ROMERO     : ALFREDA DUSTY DEANNE 
RIVERA     : TREVINO 
JOY        : ALTON 
ALTA       : NORRIS OSCAR STEPHENSON 
MARIE      : NICHOLSON THOMAS 
MCCULLOUGH : RICO RICHARDSON VELASQUEZ 
SEARS      : FERRELL 
NEWMAN     : BOWMAN MAYS 
JODIE      : MAYER MILDRED AVIS 
JAIME      : LESTER 
BROCK      : SUSIE GALLAGHER 
SLOAN      : EVERETT 
NICOLAS    : ALFRED KIDD 
HENSON     : ERNA 
CLAUDETTE  : FRANCES ALBERTO CANDY 
MILLICENT  : NORRIS RICK 
RIOS       : BORIS ROBLES HEATH 
XAVIER     : WEAVER EVANGELINA 
CONLEY     : MARGARITO 
ROSE       : BASIL STEVENS BILLIE 
MARYANNE   : GALLOWAY MARGERY 
DAVIS      : LEMUEL 
POTTS      : ALTA 
MEDINA     : PETERSEN 
WIGGINS    : BRIGHT INGRID ROBBINS 
BRANDY     : NICHOLS 
BERTIE     : EVE HICKS 
BRIGHT     : JAIME DOYLE 
FRANKS     : CROSBY PHILLIP 
FORBES     : DERICK VAN JAYNE 
MARY       : NOE PAULETTE 
CARLENE    : YOUNG HINTON 
HARVEY     : TREY KYLE NETTIE 
MILLER     : TUCKER PETERSEN ALFONZO 
DARRELL    : BENJAMIN WARREN 
FEDERICO   : LORIE WHITFIELD 
LEWIS      : TAMMY RODNEY ALTON 
CECIL      : HARDY 
RICO       : OLSON 
LUCIANO    : BURGESS 
FRIEDA     : OBRIEN GLASS DARYL 
PETTY      : SCHNEIDER 
TAYLOR     : SANTIAGO 
ERIKA      : RICK BENJAMIN 
WILFREDO   : MAVIS 
STRICKLAND : LITTLE GRIMES 
CASANDRA   : SERRANO 
FREDDIE    : ANTONE 
ISRAEL     : BOWEN JANICE 
AMANDA     : TOM 
MOLLIE     : JAY PAT 
GILL       : ELVIRA RANDOLPH BURRIS 
BONITA     : LEON 
GARRY      : WOODWARD KATY CHARLENE 
JORDAN     : WALTERS MENDOZA 
KATHY      : REESE BARRERA 
DAPHNE     : KATHERINE MILLICENT RACHAEL 
WALSH      : CUNNINGHAM PERRY JEFFERSON 
ANDREA     : ISIAH CALVIN 
TAMERA     : HENDERSON BRADSHAW 
NOE        : CURRY 
GIOVANNI   : WILKINSON HELENA 
WILL       : MAE ROBINSON 
JOYCE      : MAYNARD 
WHITLEY    : STEWART ESTRADA BAIRD 
WEEKS      : MARCIA DIXON 
HILARIO    : PAM LINDSEY TYLER 
CHAN       : HUMBERTO HEAD STANLEY 
BEST       : BOWEN LEANNE FOSTER 
FLORES     : INA DECKER ERICKSON 
JOANNA     : JIM 
DONNY      : ROBINSON ROSARIO 
BRADLY     : ROD JIMMIE 
BUTLER     : ART RICHMOND 
VASQUEZ    : RANDALL ANDREW 
NICHOLS    : NANCY 
KERRY      : HOOD BOBBI IVANA 
BORIS      : SWEET 
VICKY      : LLOYD BRUCE 
COOK       : RANDOLPH HOLDER PERCY 
ROY        : IAN TURNER 
BOWERS     : MARSH CAROLE 
HEATH      : FERRELL CHERRY ENID 
STOUT      : JUANITA SHERMAN ROBERT 
CLYDE      : ANTONIO 
DANIELLE   : NEIL SUSAN PHOEBE 
PHILIP     : NORA 
HANEY      : MARY AHMED BLANCHARD 
RUTLEDGE   : GREGORY DOYLE 
DONA       : ERNIE SALVATORE 
LOURDES    : MILDRED BRADSHAW HAYS 
MCFADDEN   : LINDA NOEL 
TIMOTHY    : LORENZO PHELPS BRAY 
DIANE      : CAIN COLEMAN 
NEAL       : FINLEY 
KATHARINE  : SARGENT ALVAREZ SIMS 
KRISTINA   : KRAMER 
BOBBIE     : BORIS MCCALL WALTON 
MANUEL     : DAVENPORT NOLAN FINLEY 
ANNMARIE   : WILLARD BRADLEY 
SCOTT      : KELLEY STANTON 
PECK       : CLINT FRANKLIN 
CANTRELL   : TONI STRONG MONTOYA 
JULIO      : LESTER 
ABEL       : MCCALL WILLIE 
ROCCO      : DYLAN 
FIGUEROA   : ROMAN 
JULIA      : MONICA 
HENSLEY    : OCTAVIO ANNETTE AUBREY 
ROXANNE    : ELVA BUCKLEY 
BURTON     : JOSE MARCY FERN 
GLADYS     : ALBERTO NUNEZ 
SIDNEY     : ALYSON 
WOODWARD   : PETTY LEACH LEVI 
LAMBERT    : OCTAVIO FERNANDEZ MILLS 
DEANA      : QUINCY TANYA 
CAROLYN    : ARNULFO HECTOR 
CUNNINGHAM : KLINE BUCKNER 
SARA       : BARBRA ROBLES 
KERI       : HELGA 
GONZALO    : MORRIS TIMMY MEADOWS 
DOYLE      : IGNACIO 
ADAM       : BRYAN KIP DARRELL 
IGNACIO    : ANIBAL 
GREGORY    : THURMAN OLA BROCK 
WOLFE      : MARISSA 
MILES      : ABEL HOLDER ROXANNE 
HORN       : ESTRADA 
MORRIS     : BRIANA 
STARK      : VICTOR BRIGHT NEWTON 
LORENZO    : KARYN KOCH RODGERS 
KENNEDY    : ANDREW CECELIA 
ROBLES     : WALSH ALYSON CASTRO 
LEBLANC    : WHITE RONNY CHANDLER 
REUBEN     : CONRAD 
LYMAN      : KERI SIMON SPENCE 
DALE       : SAMUEL WISE 
DARCY      : POLLARD 
SERGIO     : CECELIA CASTRO ELIJAH 
DONNA      : JAMAR PRISCILLA 
ENRIQUE    : SIMONE JERALD 
SHERYL     : LENORA BAKER MOSLEY 
MARTINEZ   : GARZA WOLFE JOANNA 
ART        : HENDRICKS JAMAR 
LOTTIE     : VALERIE EARL JACOBS 
CHERI      : KLINE RAMSEY JARVIS 
COLLIER    : MERLIN 
HINTON     : DINO HUFFMAN 
HUBER      : FRANKLIN 
MIKE       : VARGAS 
RONALD     : JARROD SIMPSON 
MCCALL     : AYERS BRIDGET WILKERSON 
ALFREDA    : MADDEN 
KARYN      : JIM 
THOMPSON   : VONDA 
HURLEY     : VICKI BOBBI CONSUELO 
HULL       : CAROLYN 
MARCI      : ROBINSON MCMAHON 
TAMMI      : AVA WEBSTER BURGESS 
ELISEO     : WASHINGTON LORENA 
CAMACHO    : PARRISH DON 
LENORE     : BURKS 
BOYD       : HODGE 
HEIDI      : HART 
CARISSA    : MARGARITA ISABELLA EARNEST 
MALDONADO  : BARNETT 
CARMINE    : SOSA 
PAULETTE   : MAVIS JESSIE 
HOPKINS    : DUKE 
MARYELLEN  : DEANA 
MOSS       : LEONARD 
CHANDLER   : MOLLIE GARZA COMPTON 
GRETA      : WATTS 
LORRAINE   : MILLS WALDO ABRAHAM 
RASMUSSEN  : NICHOLS KENNEDY GALLAGHER 
CROSS      : MARTHA LINDSAY STEPHENS 
AYERS      : ROBERT LENORA 
BEACH      : ELIZA MILLICENT BRADFORD 
ODOM       : FRANKIE ROWE 
KENDALL    : CASEY KELLEY 
PAM        : SELENA EDGARDO 
VICTORIA   : SALINAS FRY MANNING 
DENA       : CAIN BOBBIE MCFADDEN 
LANE       : DIONNE 
SUAREZ     : EMILE LITTLE 
MARA       : WALTON ANTHONY HENRIETTA 
CLAY       : STANLEY 
HOLLIE     : CATHRYN 
CHAVEZ     : MASSEY MARYELLEN 
LES        : MONTOYA ROY RAYMOND 
THURMAN    : CASSIE MERCADO GLASS 
HUGH       : CINDY ELBERT 
SCHULTZ    : TERRI 
SAMUEL     : MARISOL STANLEY 
FRANCESCA  : CLAYTON HOOD 
HOLCOMB    : KELLER STRONG GILES 
SHANA      : ALBA 
BUDDY      : BRENDAN FREDERIC FUENTES 
NIGEL      : INGRID 
MILLIE     : ENGLISH JOY ISIAH 
RICHARDS   : FLOYD BARNES 
BERGER     : XAVIER ARTHUR 
BURCH      : BRYAN GENARO ADKINS 
SOLIS      : ALBA BRANDI 
FARLEY     : HENDRIX JACKSON 
DOMINGO    : JULIET JENNINGS 
DOROTHEA   : HAWKINS ROJAS JESSICA 
ELIZA      : JOSUE 
RODRIGUEZ  : HOGAN VICKI 
JOSEPH     : SHEPHERD 
GALEN      : FLORINE HOOD 
MOLINA     : CONSTANCE DELMAR LUCIEN 
RICARDO    : CLEVELAND REYES 
CARMELO    : MARVIN HEATH PACHECO 
RODGERS    : DEJESUS TONI 
ORR        : HOGAN KELLER 
DAWN       : DENIS 
PETER      : SAUNDERS BRADSHAW 
LULU       : SCOTT DEAN 
TREY       : NIELSEN HERIBERTO RODERICK 
HENDRIX    : RICARDO ALICIA ROCKY 
SUSAN      : TRICIA RAMIRO 
LUPE       : ROY 
JONI       : POOLE STACIE 
HERMINIA   : LANE MCCULLOUGH KOCH 
EVERETT    : JOHANNA 
WEAVER     : JORDAN CHERI 
NETTIE     : HUGH ERNA MCCARTY 
WILLIS     : GILMORE 
VERN       : BRYAN WINFRED PARSONS 
RITA       : MASSEY TABITHA DEWAYNE 
EMILE      : AIDA 
FERNANDEZ  : BRIGITTE INES ROSA 
ALVAREZ    : HANSON BRAY GIBSON 
ED         : JARED ROBERT 
BOYER      : PAULETTE 
FLORINE    : HOLDER BILLIE WILCOX 
FOWLER     : ROBT DANIEL OLSEN 
LATISHA    : REINALDO DIXIE 
LETICIA    : BUCK MERCER 
CARLO      : KARYN JOAN 
CONRAD     : DARRYL 
ELVIRA     : FULTON FERRELL 
MERLIN     : LEONARD 
KOCH       : ART HARRISON TANYA 
PARK       : MACIAS LANGLEY 
KEVEN      : HENDRIX KATY 
ARMSTRONG  : JACOBS 
KURT       : KNOWLES RASMUSSEN 
ZAMORA     : FRANCES MERCADO NIKKI 
SEBASTIAN  : FRY 
AL         : RICHARDSON ANTONE RAMOS 
MARCUS     : FANNIE WILLARD FRY 
MICHEAL    : ROSETTA POLLARD 
BLANCHARD  : JORDAN GILL 
TREVINO    : FLOYD 
DUSTY      : HEAD JILL PETERSEN 
BRIGITTE   : DAREN RICARDO ETTA 
ROSS       : COLEMAN 
SONYA      : HOMER POTTS PATSY 
LELIA      : MCGOWAN BRADSHAW MARY 
ROSEANN    : CORRINE 
OTIS       : MACK 
NORRIS     : DEANDRE BARKER 
SALAZAR    : DALE QUINN CONLEY 
MAE        : CARLO ETTA 
WILEY      : MARGERY 
LEVINE     : INES ROMERO 
NITA       : CLYDE 
CATHERINE  : HULL 
BARKER     : DOMINGO HANNAH CHELSEA 
JESSIE     : TRENTON 
PATEL      : CROSS 
LORI       : LARSON GARRY TERRENCE 
TERRI      : WILFORD 
MAYS       : NORMA 
FOREMAN    : TREVINO CASSIE 
ROCKY      : ROSALES 
GERARDO    : ERICK DAWN 
FRANCES    : CECIL ROSETTA 
EDGARDO    : SALINAS JULIAN ANASTASIA 
PORTER     : OTTO JOHNSTON AUTUMN 
NANETTE    : HUGH JANINE RIOS 
PACHECO    : ISSAC TATE 
KATHLEEN   : CARDENAS BRUCE HIGGINS 
SHIRLEY    : GARRY 
AURELIA    : MAYNARD 
POPE       : MAVIS AVA 
VICTOR     : HUBBARD KEVIN VALERIE 
DANIELS    : WILEY 
MARTHA     : DYLAN JOANNA 
BRIANA     : VEGA ADKINS 
REYNA      : MARCUS HOUSTON DAVIS 
QUINCY     : RICO 
HOLDER     : SANFORD CANDY BRADSHAW 
NAPOLEON   : MYRA FRANCIS 
GABRIELA   : RAMOS 
BETHANY    : PARKS DENNIS REESE 
SHEPARD    : SUAREZ CASEY 
LAUREL     : VANCE BEACH 
FLORENCE   : SWANSON 
ROSA       : TURNER ANTHONY 
HAROLD     : RAYMOND LANCASTER KARYN 
SANDOVAL   : SOLOMON MENDOZA 
HENRIETTA  : ROBERT MOSLEY FRYE 
WHITFIELD  : LORNA FROST GRETA 
CLARA      : REEVES HENSLEY ROSEANN 
FULTON     : MARION AMANDA LESLIE 
ROBIN      : TOMMY 
WALTER     : RITA DELORIS 
JANINE     : ADKINS MCCULLOUGH LUCIANO 
BENTLEY    : WOLF 
JASPER     : NOELLE SALVATORE BOYLE 
ERNESTINE  : NOLAN LEVI 
GARZA      : OSCAR GALEN 
EVANGELINA : SUZETTE WOODWARD LACY 
SHAWN      : DEWAYNE JEWELL 
INGRID     : SUZETTE 
LINDA      : DELACRUZ STEVEN 
SIMS       : MILLIE 
MURIEL     : NANETTE HIRAM 
ANNETTE    : ELLIS LUCIANO 
LORIE      : GARRY 
MYRA       : MERLIN ROBIN 
GLASS      : JARRED 
LINDSAY    : GIBSON 
ROBT       : ROSEANN ALVIN PETTY 
PRUITT     : ROBBY BUCKLEY MARTHA 
FOSTER     : SELLERS BLANCHARD 
VINCENT    : TRAVIS 
NOELLE     : ADAM CHAN 
GOODMAN    : SHERMAN DEWITT NORRIS 
RYAN       : TRICIA GLORIA 
RICHMOND   : GIBBS 
LUCAS      : DIXIE ALTON AVIS 
DYER       : CAMACHO 
RUSSELL    : JARRED ANNETTE ANA 
BOB        : BARNES TIMMY NEAL 
MARIANA    : RUSSO GUY MAYER 
CRANE      : GONZALEZ LAUREN 
ADELINE    : HUFFMAN ELIZA ELVIRA 
GINGER     : VICKY TRENTON 
NANNIE     : LUCAS PHELPS YANG 
MALLORY    : FISCHER MCMILLAN LORENZO 
REESE      : MOSS 
WILBUR     : FULTON MARTINEZ 
CLEVELAND  : SERRANO PARSONS 
HOLT       : MAURICE POOLE MARIE 
LEONEL     : OLA HOLLOWAY DUNCAN 
BOOTH      : JEWELL WATERS 
FERN       : ENRIQUE 
CALDWELL   : WOODARD 
WILFORD    : ROSA CONNER ALEXANDER 
HENDERSON  : CASE HENRY 
LANCASTER  : BETTE OCTAVIO 
MARGARITO  : WENDY 
BOLTON     : IVANA MOHAMED 
BRUCE      : MICAH CHRISTI 
DENNIS     : KEVEN ERIKA REFUGIO 
HAYS       : CONTRERAS ALFONSO 
SUZETTE    : TRACEY EARLENE DAVIS 
BROWN      : MARIBEL LEMUEL SOTO 
KELLEY     : BORIS 
RODRIQUEZ  : COLLIER MCDONALD 
JERALD     : ROBERTSON 
DELACRUZ   : PATEL SIMON 
FREDRIC    : CANDICE BULLOCK MCKEE 
ANA        : CHUCK 
JIMMIE     : MARGARITA 
MYERS      : CATHERINE DANIEL 
EARL       : MOSS 
VIRGIE     : TORRES 
STEVEN     : SAM ALFREDA EFREN 
ANTONIA    : SELLERS MAXINE LACY 
LIZZIE     : SHARON 
CATHRYN    : MCLEOD 
MARGERY    : MELBA PICKETT MCINTYRE 
SNOW       : BLEVINS JILLIAN WILKINSON 
WISE       : CANDICE 
AUGUSTINE  : COLLINS SALINAS 
GLORIA     : FREDDIE ALBA MERCADO 
CONTRERAS  : STOUT MICHEAL 
FLEMING    : ELDON ROCKY 
CAMERON    : DERICK 
ESMERALDA  : ROBIN PUGH 
HICKS      : RODRIQUEZ RANDALL ELOISE 
OMAR       : TRAVIS 
GEORGE     : LETITIA ROSA HARRINGTON 
AURORA     : DAPHNE ELMA 
PRISCILLA  : JEWELL MCLAUGHLIN AUGUSTINE 
CALLAHAN   : CHAN AMIE 
ROSEMARY   : SWANSON BEASLEY 
FRANCIS    : AUTUMN RICHARDS MYRA 
TAMMY      : STACIE BOYER JAMEL 
LEANN      : BURCH 
ERICKA     : PETERSEN LESSIE HOLT 
JANETTE    : ELVIRA HAYDEN KELLER 
EARLENE    : BULLOCK 
JACOB      : TURNER 
CONNER     : BRYON 
DELMAR     : AISHA 
TATE       : DALTON KERI 
KIP        : ERIK COLLINS 
WALLS      : MENDOZA 
NIKKI      : MARCIA PITTMAN CLEMONS 
GUTHRIE    : DUFFY DAREN ODONNELL 
ASHLEE     : JOSE DOROTHEA 
MASSEY     : COMBS 
TOMMY      : DUFFY 
STEVENS    : LOWE 
COLLEEN    : SARA ROB 
VEGA       : SAMPSON ALI 
TERRY      : HOLLOWAY CARROLL CHUCK 
NORA       : CONNER FINLEY 
JESSE      : CARLO ANNMARIE ROTH 
ASHLEY     : MEREDITH 
BERNADETTE : PATEL LAWANDA 
TIMMY      : GOLDIE 
JANICE     : FLYNN DEENA 
MONTOYA    : JILLIAN MOODY 
EFREN      : GIBSON 
HERIBERTO  : LANGLEY DIONNE HOLDEN 
SHARON     : PETERSEN LLOYD 
JUANITA    : BROCK 
AHMED      : BUCKLEY 
CARR       : ROCCO 
JARROD     : FERNANDEZ MACDONALD COOLEY 
STEWART    : HOUSTON 
RAY        : BOYER WENDI 
TRAN       : ELOISE 
MCCORMICK  : LE DUNLAP 
JUAREZ     : LANCASTER ISSAC 
VALENTINE  : CAROLE TAMMI 
SERRANO    : LUCILLE CAROLYN 
DUKE       : FLORINE CROSBY HUBBARD 
HECTOR     : HOLT MARGARITO CAIN 
LACY       : EVE INGRID 
AVERY      : ROSALES MARION DONA 
MELBA      : LIDIA 
GOLDIE     : TY ROBERTSON 
ISIAH      : ROSALES MERLIN LES 
JEREMY     : MARTHA ERNA ALI 
BARBER     : CHAN JARRED ADAM 
LOWE       : ANNABELLE NIELSEN KAUFMAN 
ALFONZO    : MCCRAY 
BUCKLEY    : KELLY 
CRAIG      : KATHY STEPHENS WINFRED 
ROBBINS    : MARISSA WATERS CARROLL 
MABEL      : SAUNDERS 
RUSS       : RIVERA CASSIE 
KIDD       : BARNES ZAMORA 
FAULKNER   : PHELPS GUZMAN ALBA 
SAMPSON    : HENSLEY TANNER HAWKINS 
ANDREWS    : CRYSTAL SALAZAR 
SALINAS    : NIELSEN 
DELANEY    : GUY 
AVA        : HAYDEN AYALA 
NEIL       : CORTEZ CHRISTINE 
RAYMOND    : LORRAINE JARED MIKE 
BUCHANAN   : DEANA 
EMILY      : JOHNSON 
CONCEPCION : BATTLE 
KAUFMAN    : THADDEUS 
BRADLEY    : PETER POPE 
JAYNE      : BASIL DONA 
SIMONE     : JAY EARNEST SIDNEY 
SHEPHERD   : MCKAY EARLENE 
WILLIAMS   : KATY DALE CHERRY 
MCINTYRE   : MCNEIL REYNA 
WILKINSON  : ROBBIE 
CAROLINE   : LENARD BENTLEY REYES 
HOMER      : MARCI 
PARRISH    : GUY 
COX        : ALINE EUGENIA 
STACI      : BERT POOLE ELIZA 
JACOBS     : BLEVINS JOHNS COX 
ROSARIO    : YOUNG WEBER 
MEADOWS    : ANNABELLE HORN FLORENCE 
BRADSHAW   : ROTH 
MUELLER    : NAVARRO TREVINO 
HAZEL      : CROSS BRANDY 
JARRED     : NADINE JANINE 
BRUNO      : MICAH 
SWANSON    : DUNN 
CARROLL    : ABEL PRUITT EFREN 
VALENCIA   : DIXIE DELGADO 
PRESTON    : EDWIN LANGLEY GIOVANNI 
PEREZ      : MILDRED 
MARCELO    : HERMAN 
MILLS      : KEITH CHARLOTTE NIELSEN 
GENEVA     : CALLAHAN GIBSON 
ERMA       : TURNER ABE 
TINA       : ROSALINDA BOB MOODY 
TOWNSEND   : RAYMOND ANGIE ROSEMARY 
BRENTON    : LIZZIE 
DELORIS    : THOMAS PITTS 
CANTU      : MAE 
PAYNE      : FORREST HORN 
ANTHONY    : JESSE 
DELGADO    : HERBERT ENGLISH LUNA 
MCCRAY     : ADELINE 
FREEMAN    : CARLA 
ESTEBAN    : SOLIS BRIDGET SOLOMON 
GRACE      : ROSS 
ADAMS      : CARVER MURIEL 
RICKY      : ELISEO 
LORENA     : ELLIOTT KNIGHT ROSE 
KARLA      : FUENTES DAMIAN 
WOODARD    : HEBERT 
JARED      : PITTMAN TRACEY MAVIS 
WELLS      : ONEIL SALINAS 
NEWTON     : CARVER MICAH MIKE 
BURRIS     : BUCKLEY ROSALINDA MOSES 
MARCY      : MERLE HELGA 
BENITO     : LUNA NICOLE 
LARSON     : FANNIE 
VICKI      : BRYON NORRIS 
DONALD     : HENRIETTA 
WENDY      : JULIA MARGARITA NICOLE 
AUBREY     : BOBBIE CAITLIN OLSON 
DAVID      : DEJESUS 
COMPTON    : NANETTE 
PUGH       : RAMOS PARSONS 
MENDOZA    : BERTIE NANNIE MADELINE 
KEITH      : SAVANNAH 
MERLE      : TODD JOHN 
BREWER     : HERSCHEL 
VERNON     : POTTS EMORY JULIAN 
SCOTTIE    : PHILLIP KRISTOPHER 
ALICIA     : MILES FAITH ANDY 
EARLE      : GREENE WATTS 
IAN        : NUNEZ KEITH 
JEAN       : DAVID 
SAUNDERS   : JULIO PHELPS 
DECKER     : HEIDI CORNELIUS 
JOSUE      : RICK KENNEDY BARBRA 
SYKES      : FIELDS ISSAC 
MILDRED    : AUBREY LATONYA 
SYBIL      : RICHARDSON 
DEANNE     : CASE 
BONNER     : JASPER 
NIELSEN    : ALFONZO 
ENGLISH    : ROSS ODELL 
HOUSE      : OMAR HARRINGTON 
LEONARD    : TIMMY ELIZA KAUFMAN 
WATERS     : HIGGINS KURT 
BENTON     : MARK 
HARMON     : ROY SAVAGE 
DIXON      : SEBASTIAN 
ISABELLA   : CHANDLER FULTON 
GARNER     : CHRISTA LYDIA DELORIS 
MOODY      : DAVENPORT DEANA 
LUISA      : PITTMAN TOM 
PUCKETT    : JOHNATHAN 
WALL       : DARNELL JOHNSON 
DEMETRIUS  : SHARON LORIE GREGORY 
MOHAMED    : RASMUSSEN MANNING 
GIBSON     : ANIBAL 
SOLOMON    : BRIDGETTE 
GOOD       : BETH DARRELL 
ELVA       : FRANCISCO LOTT ROSALES 
NIEVES     : ART BRIDGETTE 
JEWELL     : EMORY ANITA 
JOSE       : GRETA FLETCHER 
DIXIE      : PARRISH 
GRAY       : KATHERINE BERGER 
FULLER     : GILBERTO 
ELDON      : GOOD TERENCE DEAN 
JESSICA    : BURKS 
GILLESPIE  : SWANSON 
ALEXANDRA  : FRANCES CASTRO WILL 
IRA        : ANTHONY BRENTON 
BIRD       : KEVEN 
TAMMIE     : KYLE 
RORY       : NITA 
MERCER     : PETER LUNA 
STANTON    : LUCIEN RAUL 
GRACIELA   : CAROL 
COLLIN     : REYES CANTU 
BOBBI      : STANLEY ANDERSON 
MARKS      : POTTS LIZZIE 
ADKINS     : PAULETTE BRIGITTE ROSEANN 
HERMAN     : BROCK RODRIQUEZ CHANCE 
IRVIN      : CARMELO LINDSAY 
PATRICK    : ROSS BUDDY 
VALENZUELA : ROY GEORGE PHILIP 
WILKERSON  : TONIA JACOB 
ANTONIO    : STRONG JARVIS BONITA 
HERSCHEL   : BRADLEY 
DWIGHT     : HENSLEY AIDA 
HURST      : SAVANNAH TARA JOHNATHAN 
PAT        : BOYD MAYNARD 
LAURI      : JARROD VEGA MCLEOD 
HENRY      : RITA 
MARSH      : QUINCY NGUYEN GRETA 
NOEMI      : MILLER HUMBERTO 
CHRISTIAN  : FEDERICO LORRAINE 
SHANNON    : NANETTE ALVIN 
ARNULFO    : IRIS HOGAN RUSSO 
SETH       : DIXON HARVEY 
INGRAM     : CAROL MILAGROS 
ALFRED     : STEELE WIGGINS 
CHRISTINE  : NADINE BLANCHARD 
CINDY      : TYREE CLEVELAND 
DAVENPORT  : PHILLIPS CASTRO 
SANFORD    : PHELPS MCNEIL CUMMINGS 
COLEMAN    : MINNIE 
JIM        : ABRAHAM 
GENARO     : BERT TOWNSEND 
CORINNE    : GARTH WALTON LOWE 
ELBERT     : PRISCILLA FUENTES VICTORIA 
DAREN      : VELMA MILDRED JOHNSTON 
YVETTE     : CHARLOTTE SIMS 
MORROW     : TODD 
GUZMAN     : STRICKLAND ELIZA 
NORMA      : SCOTTIE BRIANA TASHA 
DAMIAN     : ALFREDA 
HUMBERTO   : BURCH KRISTINE 
DICK       : LEE BRANDI 
SONNY      : SHAWN CAROLYN 
MATHIS     : BENJAMIN HENRY SHERYL 
JULIET     : ENID PERRY ROSALES 
KRISTEN    : JANICE CAMACHO HINTON 
SARGENT    : HERRING PAMELA 
MCCARTY    : MCINTYRE EDMUND 
TANIA      : RANDALL LINDA 
JULIE      : YANG 
RONNY      : COPELAND SERRANO HEIDI 
HENDRICKS  : PUCKETT CLYDE 
BOWMAN     : MARCY 
HARRISON   : WILL ROSS LEMUEL 
DORA       : EDGARDO 
ELIJAH     : NEAL LUCILLE MICHEAL 
ERICKSON   : BENTON 
TEDDY      : GRAY 
REFUGIO    : BONITA STACY 
LOTT       : MASSEY 
WATTS      : TERRENCE EARLE 
GILES      : CUMMINGS ELDON 
VAN        : SOTO 
BULLOCK    : CHAN 
GOODWIN    : MITCHELL MAC LEVINE 
TORRES     : WALSH ESTES DON 
WALLER     : GRETA KRISTINE 
RAPHAEL    : BOOTH RUSSEL 
ELLIOTT    : AUBREY 
MACDONALD  : PETERSON BOLTON ROSETTA 
JAMAR      : CAROLYN DARCY 
LEMUEL     : GOODMAN 
DARIN      : NUNEZ ANDERSON HALL 
ROJAS      : DOYLE AURELIA 
BOYLE      : CASTRO KRAMER CONCEPCION 
KENTON     : BOYER 
MOISES     : KIP CHUCK 
AUTUMN     : RONALD ESTELLA CANTU 
ROOSEVELT  : JONI SPENCE VICKI 
QUINN      : MACDONALD 
NAVARRO    : ELIJAH PAMELA 
FAITH      : ELDON HUGHES JESSIE 
CAIN       : ROTH 
CHANCE     : HOLT BOYER 
BRANDI     : GALEN THADDEUS 
ROSALINDA  : WITT 
PATSY      : FRANCIS MCINTYRE 
SOSA       : SILAS KEVIN DAREN 
HODGE      : FEDERICO GOLDIE FULTON 
NANCY      : MCMAHON 
LON        : ARTHUR 
TERRELL    : EARNEST REEVES KERRI 
MERRITT    : MABEL PAGE BERNADINE 
MATTHEWS   : BOLTON SHERMAN SUSAN 
CEDRIC     : HERRERA LESTER 
MAXINE     : TORRES TERRY 
SUSIE      : ENGLAND STEFANIE 
HALL       : SUAREZ LEANN 
ALYSON     : MCMAHON LENARD JACOB 
CHERRY     : CHRISTINE ENRIQUE 
CORTEZ     : HELGA 
EVAN       : TABITHA HOLLOWAY 
PHILLIP    : BONITA DARRELL ANASTASIA 
SUSANNA    : CATHRYN HUMBERTO 
MANNING    : ODESSA 
CARDENAS   : LANCASTER 
OTTO       : AUTUMN LEVINE TRENTON 
KYLE       : MARTINEZ SHANA CONTRERAS 
EARNEST    : CARVER JARROD OMAR 
OLSEN      : ELIJAH 
WILLIE     : WOLF SYKES HOOD 
SCHROEDER  : TATE 
TONI       : DON LUCIANO 
BILLIE     : ARIEL CONLEY 
OLSON      : NOEMI NICHOLS RAY 
ESTELLA    : SWEET NEAL 
ALBERTO    : CALLAHAN 
SHARRON    : FULTON THURMAN HILARIO 
EDWIN      : NORTON 
WHITNEY    : AURELIA MICHEAL 
CURRY      : HULL HARDY XAVIER 
HUFFMAN    : TOWNSEND POTTS HENRIETTA 
TERENCE    : RACHAEL 
SANTANA    : JANINE MILLICENT 
ROMAN      : WELLS SHARON ANNA 
KENDRA     : BONNER ADAM 
PETERSON   : DECKER LEVI 
ROD        : MONTGOMERY DOMINGO WALLER 
BASIL      : ERICKSON CECELIA GILBERT 
RICK       : CHANEY BOWMAN ROBT 
MICHAEL    : REUBEN 
BATTLE     : BRUNO DEANDRE 
COTTON     : LYDIA GRIMES 
BERNARDO   : DIXON AMELIA 
WASHINGTON : STANTON PAGE ANITA 
JILLIAN    : MITCHELL GATES 
TERRENCE   : ROBBY BOWERS SEBASTIAN 
HERRING    : MONICA PEREZ 
FREDERICK  : DAVID FARLEY ANNA 
DYLAN      : MARISSA ANITA 
SIMPSON    : MARGARITA SCHROEDER NIGEL 
BRADFORD   : HAYDEN 
ERIK       : SHERMAN 
CALVIN     : GATES BRADLY MORRIS 
MARIANO    : GERARDO 
BARR       : BEAN 
ORTIZ      : COOK NANCY 
DON        : BRANDI JEFFERSON 
THADDEUS   : JOAN 
SCHWARTZ   : GILBERT ENGLAND 
AYALA      : SNOW LACY MEDINA 
HUDSON     : NOEMI JENNINGS 
TRUDY      : FOX FOX 
ARTHUR     : ANDREA BAKER KENDALL 
COFFEY     : MACIAS JEAN REESE 
MAYER      : JAIME 
NADINE     : VIRGIE LESTER SONNY 
DUNCAN     : BUCKNER MERCER MAVIS 
REGGIE     : LE HIGGINS 
BLAIR      : TABITHA FERDINAND 
SHERMAN    : LORAINE ANGIE CHRISTI 
LENORA     : OTIS MASSEY 
CHUCK      : KENTON GARTH 
GATES      : MILES MERCEDES HART 
SOFIA      : SUSANNA 
FERDINAND  : OMAR ROOSEVELT RANDOLPH 
ISIDRO     : JOSEPHINE TERRI BUDDY 
KELLER     : ALLISON 
CANDY      : CLAYTON 
JAY        : SNOW 
TURNER     : GIBBS LOGAN 
MUNOZ      : LATISHA 
VARGAS     : BONITA SEBASTIAN JEWELL 
WENDI      : SALINAS 
RANDALL    : RASMUSSEN 
JOAN       : LACEY 
ERNA       : GIBBS DAVENPORT 
VANCE      : JOSUE HOMER EVE 
AMADO      : IRIS MARIANO 
CARVER     : PENNINGTON ROBT 
LACEY      : HOLDEN FULTON PEARSON 
INA        : KATHLEEN BURKS 
HARRIET    : LORI IVANA TEDDY 
AISHA      : DELGADO SCOTT PETERSON 
ALI        : POPE 
FORREST    : OLA CARMINE MANNING 
ADDIE      : LENARD MALDONADO 
GALLAGHER  : MARCELO 
KNIGHT     : ISIAH MABEL LANCASTER 
KRISTINE   : RONNY 
ROBERT     : MANN JARVIS 
CLARENCE   : WHITFIELD 
WHITE      : KRISTEN LYNN 
KERRI      : HOGAN 
HOFFMAN    : GENARO SILAS 
TABITHA    : MCLAUGHLIN PAT JAY 
DURAN      : BROWN ISIAH 
CORNELIUS  : MASSEY 
HOWELL     : SAVAGE DELGADO 
CHARMAINE  : WONG LUISA 
ERNIE      : WILFORD 
MARSHALL   : MACDONALD ANTONIA 
HOOD       : MARCELO NANETTE 
HARRIS     : ADAM STRONG SHEPHERD 
FRANKIE    : ADDIE 
LAWSON     : CROSBY ALFONZO 
DEWITT     : HOBBS SOLIS 
LEON       : RAYMOND 
SANCHEZ    : ELVIRA 
GONZALES   : LIDIA 
JEANNE     : TAMMIE BUCHANAN VANCE 
LIDIA      : DONA SARA 
CUMMINGS   : THELMA 
HAWKINS    : TYREE ELDON 
LE         : CHANG 
ANASTASIA  : YANG DUNCAN 
ROYCE      : KRAMER CARR 
BURKS      : NANNIE 
FLYNN      : BRUNO 
DALTON     : SANTANA LEONARD 
STRONG     : BENTON DICK 
CLINT      : NOELLE SOLIS PAT 
LORNA      : BRIAN KATHLEEN BENTON 
ENID       : RODRIQUEZ PARK 
JACKSON    : DECKER 
RICHARDSON : LEMUEL JUAREZ MANNING 
BRYANT     : CHARLIE BOBBI 
CLEMONS    : WALLER 
CHARLENE   : HANNAH TRUDY CARLSON 
ROWE       : DANIAL JAY 
REINALDO   : WOODARD DANIAL 
JOHNNIE    : EVANGELINA 
TANYA      : BLAIR EMORY 
COTE       : MCGOWAN 
POOLE      : ESTES LOTTIE 
ONEIL      : GILBERT PHOEBE ISRAEL 
HELENA     : HUDSON FREDDIE ODOM 
HUBBARD    : BRYANT DIONNE 
MARCEL     : LES PAULETTE 
BRAY       : JIM WALSH 
DAMON      : PATRICK 
AIDA       : MARGUERITE 
BLAKE      : RUTLEDGE 
GEORGIA    : MORENO 
NELDA      : RICO 
GRAHAM     : MARTHA MICHAEL 
HOWARD     : PERRY HEAD 
STEVENSON  : ROSALINDA 
STACY      : ANGELITA AVIS 
CAROL      : SANCHEZ MORRIS 
MADDEN     : ANDREW DARIN ALINE 
ROSALES    : NITA SELENA ALFRED 
ALISSA     : CANDICE 
RODERICK   : THOMAS HURLEY SYDNEY 
NOEL       : KERRI SUSAN 
MCLEAN     : HODGE 
CONSUELO   : CASSIE 
CARLA      : MCINTYRE 
KASEY      : EVERETT 
MORENO     : TONIA GERARDO 
BARNETT    : ERIKA 
ANDREW     : CARLENE VALENCIA WILLARD 
SAVANNAH   : HOOPER JESSIE 
DUNLAP     : GRIMES 
MITCHELL   : CROSBY DORIS 
HEWITT     : ROJAS BUCKLEY 
BARBRA     : LESLIE 
JOSH       : ROSALIE ROMAN LEONARD 
MILO       : SALAZAR WIGGINS 
MACK       : NELDA KATHLEEN WILKINSON 
ODONNELL   : HOUSTON 
JOHNSON    : ANDREWS HINTON 
MINNIE     : AVA LESTER DEAN 
CASTRO     : DEANA TRAN 
JAMEL      : CORINNE JUAREZ MICAH 
HOLLOWAY   : GARRETT 
LANG       : ROBIN 
SALVATORE  : JOHN MORROW 
RANDOLPH   : JACOB BRUNO NITA 
TRAVIS     : EVANGELINA TANNER 
DEVON      : CARLENE PATEL ASHLEY 
FRANCISCO  : WIGGINS 
CORRINE    : MIKE LOTT JOHNSTON 
HOGAN      : DONOVAN 
DANIEL     : EARNEST ELOISE DANA 
ANGELITA   : DINO WILLIAMS TIMOTHY 
MARISSA    : CHELSEA BERNARDO COTTON 
OBRIEN     : DOYLE SOLIS LUPE 
WINFRED    : IGNACIO BERNARDO RODNEY 
CLAUDIA    : ETTA HINES ODOM 
GIBBS      : HART CAIN HURST 
FERRELL    : LEACH EARNEST 
ELINOR     : CORNELIUS WILEY 
LUCY       : FLETCHER 
GAY        : OCONNOR RAMSEY BENTON 
MOSLEY     : DON LEVINE 
FUENTES    : RUSS NICHOLS 
JULIAN     : COLON EARLE 
PASQUALE   : BENITO 
LEROY      : ASHLEY DEWITT 
DELBERT    : EARL ANNA 
DANIAL     : SILAS GOLDIE 
PHELPS     : OTIS 
MAYNARD    : ABRAHAM HOGAN CANTU 
JOYNER     : LORIE QUINN 
CURTIS     : ROBINSON ROSEMARY JACKIE 
CONSTANCE  : MAXINE KEITH WENDI 
TANNER     : BARRERA 
KRAMER     : GENARO 
MCGOWAN    : VICKI 
SELLERS    : JEREMY CAIN BROCK 
SHELLEY    : BOB JOHNSTON 
ALFONSO    : JULIO PAM CAIN 
CROSBY     : RAPHAEL PAULETTE RORY 
PARSONS    : RAY MACIAS JORDAN 
HELGA      : ROB SERGIO 
ALINE      : MERCEDES MCKENZIE 
GALLOWAY   : CARSON MERCEDES KURT 
LINDSEY    : ELLIOTT GARRETT 
JOSEPHINE  : RUSSO GRAHAM LEE 
BERNADINE  : GATES LUISA 
OWEN       : MERLE 
CASEY      : COMBS VICTORIA 
TYLER      : ISABELLE 
MARCIA     : AMADO 
COLLINS    : RONALD 
MONROE     : JACLYN 
MARVIN     : LUCIANO WALLER SIMPSON 
DUFFY      : MACK CASTRO 
JOHNSTON   : SAM 
KELLY      : JOYCE ANNA 
RUSSO      : JULIO 
BRIDGET    : NAVARRO 
LYNN       : MCCARTHY GONZALES MARCEL 
BEASLEY    : DEWAYNE 
ETHEL      : FRANCESCA 
MACIAS     : DENA 
FINLEY     : FOREST BASIL SILAS 
BARTON     : LEACH 
RUSSEL     : CATHRYN HAYS 
PALMER     : STACY 
GLOVER     : ISSAC EVANGELINE 
LAWANDA    : ALVAREZ 
EVE        : ONEIL DIAZ 
GILBERTO   : TODD JEAN 
LLOYD      : GAY 
HEAD       : BARRY EMORY 
PARKS      : FULTON ANGELITA ALINE 
MARTIN     : GABRIELA 
SAVAGE     : ROSALINDA HARMON 
MAURICE    : PITTMAN BREWER 
STEPHENSON : GREENE JERALD PEREZ 
NICHOLSON  : MARCIA ERICKA 
BRIGGS     : LENORA 
REYNOLDS   : TORRES 
REILLY     : WHITFIELD CLAY 
EVANGELINE : FRANKIE RONALD 
BRYAN      : TY HOGAN 
NGUYEN     : ADAM CECIL RODRIQUEZ 
WEBB       : MARCUS BOWMAN 
ROTH       : MARGARITA RANDOLPH MONICA 
KANE       : GRAHAM TRENTON SUAREZ 
ALBERT     : MARA ETHEL 
LESSIE     : DENIS BLAIR 
ANGIE      : MAYER ELLIOTT FRANKLIN 
DEAN       : MELBA KENNEDY 
MCCLURE    : VALERIE CHRISTIAN ONEIL 
STANLEY    : LOGAN 
MCBRIDE    : STEVEN NELDA 
HUNT       : DANIAL 
BETH       : VICTOR LLOYD KENT 
RENA       : ELIZA SHEPHERD FROST 
ROBERTSON  : RAUL 
KEVIN      : COLON 
KRYSTAL    : KYLE 
WELDON     : GEORGE 
ESTRADA    : CONCEPCION 
GREENE     : TATE FUENTES KNOWLES 
MCMAHON    : CURRY 
TRENT      : SYDNEY 
REGINA     : GILBERTO FOREMAN PHILLIPS 
POLLARD    : DANIEL 
QUINTON    : CONLEY VELASQUEZ DANIEL 
CAROLE     : DILLON SHARON 
HOLLAND    : BRADSHAW HOLMAN ALFONSO 
KERR       : DAWN 
DARRYL     : RICARDO PRESTON 
CHARLES    : FLEMING 
LOGAN      : BAKER MCCARTHY 
CASSIE     : ALFONSO NIKKI MAYNARD 
BOWEN      : NICHOLSON 
HARPER     : WOODARD ERNA PETTY 
FRANKLIN   : CATHRYN LIDIA 
WONG       : BRIAN KATHLEEN 
MERRILL    : BLEVINS SAM CORTEZ 
MONA       : LAWANDA PAYNE 
TONIA      : ART ISABELLE CONSTANCE 
DANA       : BLAKE WILCOX SHAWN 
ANNABELLE  : ZAMORA GLASS MARK 
TY         : MAE 
HILL       : RENA KRISTEN ISSAC 
BAUER      : JAIME RITA 
TRACY      : DELBERT MACK ERICKSON 
HAYDEN     : EVERETT FINLEY 
NATASHA    : MARCI AHMED STEPHENS 
RAUL       : RANDALL MARIANA 
VAUGHN     : MCCARTHY LETITIA 
LORAINE    : CHRISTA GERARDO FERN 
RACHAEL    : BRADFORD 
SHERRI     : LEVI COOLEY MCCARTHY 
PETERSEN   : ALI 
